--------------------------------------------------------------------------------------------------------------------------------------------------------------------------------------------------------------------------------
--------------------------------------------------------------------------------------------------------------------------------------------------------------------------------------------------------------------------------
-&&&-----------------------123---------------123---------------------------123---------------123---------------------------123---------------123---------------------------123---------------123--------|------------------123--
1Q@Q--------------123------1231223-----------1231223--------------123------1231223-----------1231223--------------123------1231223-----------1231223--------------123------1231223-----------1##1223----|---------123------12312
&&&&&-------------123---------1223--------------1223--------------123---------1223--------------1223--------------123---------1223--------------1223--------------123---------1223------------##1223----|---------123---------12
@@N@@-----------------------IBBB---------------------?????-----------*BBB--------BBHBB------BBBB-----------------------------mBBB-----------------------------------BBBBB---m-------------i---##--------|-----------------------
@@N@@-------------------g---------------------------------------------------------------------------------------------------------------------------------------------------------------------##--------|-----------------------
&&&&&&&&&&&&&&&&&&&&&&&&&&&&&&&&&&&&&&&&&&&&&&&&&&&&&&&&&&&&&&&&&&&&&&&&&&&&&&&&&&&&&&&&&&&&&&&&&&&&&&&&&&&&&&&&&&&&&&&&&&&&&&&&&&&&&&&&&&&&&&&&&&&&&&&&&&&&&&&&&&&&&&&&&&&&&&&&&&&&&&&&&&&&&&##&&&&&&&&|&&&&&&&&&&&&&&&&&&&&&&&
@N@N@@@@@@@@@@@@@@@@@@@@#@@@@@@@@@@@@@@@@@@@@@@@@@@@@@@k@@@@@@@@@@@@@@@@@@@@@@@@@@@@@@@@@@@@@@@@@@@@@@@g@@@@@@@@@@@@@@@@@@@@@@@@@@[]@@@@@@@@@@@@@@@@@@@@@@@@@@@@@@@@@@@@@@@@@@@@@@@@@@@@@@@@@@##@@@@@@@@|@@@@&&&@@@@@@@@@@@@@@@@
@N@N@@@@@@@@@@@BmB@@@@@##@@@i@@@@@#@@@@@@@@@@@[]@@@@@M????@@@@@@@@@@B@@@@@[]@@@????@@???@@@@@@@@@@@@@@@[]@@@@@@@@@@@@@@@@@[]@@@@@@pP@@@@@@@@@@@@@@@@@@@@@@@@@@@@@O@@@@@@@@?@@@@@@@@@@@@@@BB@@@##@@@@@@@@|@@@@Q@Q@@@@@@@@@@@@@@@@
@@@@@@@@@@@@@@@@@@@@@@###@@@@@@@@@#@@@@@@@@@@@pP@@@@@@@@@@@@@@@@@@@@@@@@@@pP@@@@@@@@@@@@@@@@----@@@@@@@pP@---@@@@@@@g@@@@@pP@@[]@@pP@@@@@@@---@@@@@@@@@@--#@@@@@@@@@@@@@@@@@@@@@[]@@@@@@@@@@@@##@@@@@@@@|@@@&&&&&@@@@@@@@@@@@@@@
N@N@N@@@@@@@@@@@@@@@@####@@@@@@@@@##@@@@@@@@@@pP@@@@@@@@@@@@@@@@@@@@@@@@@@pP@@@@@@@@@@@@@@@@----@@@@@@@pP@---@@@@@@[]@@@@@pP@@pP@@pP@@@@@@@---@@@@@@@@@@--#@@@@@@@@@@@@@@@@@@@@@pP@@@@@@@@@@Y@##@@@@@@@@|@@@@@N@@@@@@@@@@@@@@@@@
N@N@N@@@@@@@@@@@@@@@#####@@@@@@@kk##@@@@@@@@@gpPg@@@@@@@@@@@@@gg@@k@@@@gggpP@@@@@@@@@@@@@@ggg---@@@@@@@pP@---@@@@@@pP@@@g@pP@@pP@@pP@@@@@k@---@@@@@@@@@J--#@@@@@@@@@@gg@@J@J@@@@pP@@@@@@@k@@y@##@@@@@@@@|@@@@@N@@@@@@@@@@@@@@@@@
############################################################################################----##########---##############################---##########--######################################################################
############################################################################################----##########---##############################---##########--######################################################################
