--------------------------------------------------------------------------------------------------------------------------------------------------------------------------------
--------------------------------------------------------------------------------------------------------------------------------------------------------------------------------
-------------------------------------oo-----------------------------------------------------------------------------------------------------------------|-----------------------
--------------------------------------------g-g---------------------------------------------------------------------------------------------------------|-----------------------
---------------------------ooo------------------------------oooo----------------g------------oo--oo-----------------------------------------------------|-----------------------
-------------------------------------------------------------------------------------oo---------------------------------oo--------------------##--------|-----------------------
--------------------------------------------------oo------------------------------------------------------------------------------------------##--------|-----------------------
--------------------------------------------------------------------------------------------------------------------------------------------####--------|-----------------------
--------------------------------------------------------------------------------------------------------------------------------------------####--------|-----------------------
------------------------------------------------------------------------------------------------------------------------------------------######--------|-----------------------
-----------------------------------------------------------M------------------------------------------------------------------------------######--------|-----------------------
---------------------------------o--------------------------------------------------------------------------------------------------------######--------|-----------------------
#####------------------------------------------------------------------------------------------------------------ooo----------------------######--------|----#####--------------
################################################################################################################################################################################
