----------------------------------------------------------------------------------------------------------------------------------------------------------------------------------------------------------------------------------------------------------------
----------------------------------------------------------------------------------------------------------------------------------------------------------------------------------------------------------------------------------------------------------------
---------------------------------------------------------------------------------------------------------------------------------------------------------------------------------------------------------------------------------|------------------------------
---------------------------------------------------------------------------------------------------------------------------------------------------------------------------------------------------------------------------------|------------------------------
-------------------------------------------------------------------------oo------------------------------------------------------------------------------------------------------------------------------------------------------|------------------------------
------------------------------------oooo---------------o-o-o------------o--o---------------------ooo--M-----ooo----------------------oooooo----------------------------------------------------------------------------##--------|------------------------------
--------------------------------------------------------o-o------------------------------------------------------------------------------------------------------------------oooooo-----------------------------------###--------|------------------------------
--------------------------------------------------------------------------------------------------------------------------------------------K------------------------------------------------------------------------####--------|------------------------------
-----------------------------------------------------------------------------------------------------------------------------------------------------oooo-----------------------------------------------------------#####--------|------------------------------
---------------------------------------k------------J--------------------------r---------------r---#######------------------------------------------------------------------K--------------------------------------######--------|------------------------------
------------####################################################----############----############---#-----#----------------###--#################---------------##########--##--##--##--############---------------#######--------|------------------------------
-----------####----------------#---------------#---------------#----#----------#----#----------#---#-----#---------------------#---------------#---------------#--------#--------------#---------###-------------########--------|------------------------------
----------#####----------------#---------------#---------------#----#----------#----#----------#---#-----#-------------r-------#---------------#--##########---#--------#--------------#---------####-----------#########--------|------------------------------
######--########---------------#---------------#---------------#----#----------#----#----------#---#-----#------########-------#---------------#--#--------#---#--------#--------------#--------#############-##################################################
######-------------------------#---------------#---------------#----#----------#----#----------#---#-----#---------------------#---------------#--#--------#---#--------#--------------#----------------------##################################################
