----------------------------------------------------------------------------------------------------------------------------------------------------------------------------------------------------------------
----------------------------------------------------------------------------------------------------------------------------------------------------------------------------------------------------------------
##################################################################################################################################################-----#########################################################
#####-----------------------------------------------------------------------###-----------------------------------------------------------------##---------------------------##---------------------------------
#####-----------------------------------------------------------------------###-----------------------------------------------------------------##---------------------------##---------------------------------
----------------------------------------------------------------------------###-----------------------------------------------------------------#----------------------------##---------------------------------
-----------------######--#-#-#-#-####-####################################---------------------###--####-###--###################################---------------------------------------------------------------
###--------------######--#-#-#-#-####------###############################-------------------#-#---------#--------------------------------------#---------------------------------------------------------------
####-------------######--#-#-#-#-####------###############################---------------##---#----------#--------------------------------------#---------------------------------------------------------------
#####------------######--#-#-#-#-####------###############################--------------------#----------#--------------------------------------#----------------------w----###---------------------------------
#####-#--##-###-------------------------[]----------------------------------###-------##--#####-################################################-------####--##-=============##---------------------------------
#####-#--##-###-------------------------pP----------------------------------###-----------#------------------------------------------------------------####--##-------------###---------------------------------
#####-#--##-###-------------------------------------------------------------###-----------#------------------------------------------------------------####--##-------------###---------------------------------
#####-#--##-###########################################################################---#---#################################################################-------------####################################
#####-#--##-###########################################################################---#---#################################################################-------------####################################
