--------------------------------
--------------------------------
-----------p------1223----------
---1223----p------1223----------
---1223----p--------------------
-----------p--------------------
-----------p--------------------
---------12p--------------------
-&&&-----12p--------------------
-Q@Q-------p--------------------
&&&&&------p--------------------
@@N@@-----{}----------------123-
@@N@@-----dD----------------123-
################################
################################
