------------------------------------------------------------------------------------------------------------------------------------------------------------------------------------------------------------------------------------------------------------------------------------------------------------------------------------------------
------------------------------------------------------------------------------------------------------------------------------------------------------------------------------------------------------------------------------------------------------------------------------------------------------------------------------------------------
################################################################################################################################################################################################################################################################################################################################################
-----------------------------------------------------------------------------------------------------------------------------------------------------------------------------------------------------------------------------------------------------------------------------------------######--------------##---------------------------------
-----------------------------------------------------------------------------------------------------------------------------------------------------------------------------------------------------------------------------------------------------------------------------------------######--------------##---------------------------------
-------------------------------------------------------------------------------------------------------------------------------------------------------------------------------------------------------------------------------------------------------------------------------------------------------------##---------------------------------
----------------------------------------------------------------------------####------------------------------------------------------------------------[]--------------------------------------------------------------------------------------------------------------------------------------------------------------------------------------
###---------------------------------------------------------------------------------------[]------------------------------------------------------------pP----------------------------------------------------------[]--------------------------------------------------------------------------------------------------------------------------
####-----------------------------------------------------------------------------[]-------pP----------------------------------------------------------------------------------------------------------------[]------pP--------------[]----------------------------------------------------------------------------------------------------------
#####----------------------------------------------------------------------------pP-------pP----------------------------------------------------------i-##--------------------------------------------------pP------pP--------------pP----------------------------------------------------------------------###---------------------------------
#####--------------------------------------------------------####---------#######pP#######pP###---------------------------[]------------------[]-----------------------------------------------------#######pP######pP#####----#####pP#########################--------------------------######-------------###---------------------------------
#####--------------[]------------------------------[]--------####---------#######pP#######pP###--------------------[]-----pP--------[]--------pP---------------------------------------------------[]#######pP######pP#####----#####pP#########################----[]-----[]-------------######-------------###---------------------------------
#####--------------pP------------------------------pP------ggg###---------#######pP#######pP###--------------------pP-----pP----t-t-pP-----K-KpP-----------K-K-------------------------------------pP#######pP######pP#####----#####pP#########################----pP-----pP-----h-------######-------------###---------------------------------
#####-----#########pP##############################pP############---------#######pP#######pP#######################pP#####pP########pP########pP--#################################################pP#######pP######pP#####----#####pP#############################pP#####pP########-----######-------------####################################
#####-----#######################################################---------#####################################################################---#########################################################################----#####################################################-----######-------------####################################
