------------------------------------------------------------------------------------------------------------------------------------------------------------------------------------------------------------------------------------------------
------------------------------------------------------------------------------------------------------------------------------------------------------------------------------------------------------------------------------------------------
----------------------------------------------------------------------------------------------------------------------------------------------------------------------------------------------------------------------|-------------------------
----------------------------------------------------------------------------------------------------------------------------------------------------------------------------------------------------------------------|-------------------------
----------------------------------------------------------------------------------------------------------------------------------------------------------------------------------------------------------------------|-------------------------
------------------------------------------------------------BBBBBBmB-----------------------------------------------BmBBBBBB---------------------------------------------------------------------------------##--------|-------------------------
----------------------------------------------------------------------------------------------------------------------------------------------------------------------------------------------------------------------|-------------------------
----------------------------------------------------------------------------------------------------------------------------------------------------------------------------------------------------------#-----------|-------------------------
-----------------------------------------------------------------h---------------------------------------------------h------------------------------------------------------------------------------------------------|-------------------------
-----------------------------------------------------[]-----BBBBBBBB---#-------------------------------------##----BBBBBBBB---[]--------------------------------------------------------------O---------#-------------|-------------------------
----------------------------------C------------------pP----------------##----------------------#-------------##---------------pP----------------------------------------[]--------------------------------------------|-------------------------
------------------C---------------c------------------pP----------------###------------C--------#-------------##---------------pP----------------------------------------pP-------------------------#--#---------------|-------------------------
------------------c-----------J---c----------------------------h-------####-----------c------J-#-------------##--------h-----------------k--------h------------h-----------------h-------h---------#------------------|-------------------------
#####################################################################--####--###############################################--##--##################################################################-----------#################################
#####################################################################--####--###############################################--##--##################################################################-----------#################################
