--------------------------------------------------------------------------------------------------------------------------------------------------------------------------------
--------------------------------------------------------------------------------------------------------------------------------------------------------------------------------
------------------1223---------------oo---------------------------1223--------------------------------------------1223----------------------------------|-----&&&-1223----------
---1223-----------1223----------------------g-g----1223-----------1223-----------------------------1223-----------1223-----------------------------1223-|-----Q@Q-1223----------
---1223--------------------ooor---------#######----1223-----oooo----------R-----g------------oo--oo1223--------------------------------------------1223-|----&&&&&--------------
--------------------------#####----------!!!!!--------------####---------------------oo---------------------------R-----oo--------------------##--------|----@@N@@--------------
---------------------------!!!--------123!!!!!----oo---------!!-------------######----123---------------------r-----------------------123-----##--------|----@@N@@--------------
---------123---------------!!!-----123123!!!!!-----------123-!!--------------!!!!--123123---------------########-------------------123123---####--------|123-&&&&&--------------
-&&&-----123---------------!!!-----#####-!!!!!-----------123-!!--------------!!!!--123-------------------123!!!--------------------123------####--------|123-@N@N@--------------
-Q@Q--------------------########----!!!--!!!!!---------------!!-------###----!!!!------------------------!!!!!!-----####--####------------######--------|----@N@N@--------------
&&&&&--------------------!!!!!!-----!!!--!!!!!-------------M-!!--------!-----!!!!------------------------!!!!!!------!!----!!-------------######--------|----@@@@@--------------
@@N@@--------------------!!!123--o--!!!--!!!!!123------------!!--------!----123!!-------------123-####---!!!!!!------!!----!123-----------######3-------|----N@N@N----------123-
@@N@@-------------####---!!!123-###-!!!--!!!!!123------------!!--------!----123!!-------------123--!!----!!!!!!--ooo-!!----!123------r----######3-------|----N@N@N----------123-
################---!!----!!!!!!--!--!!!--!!!!!----####-----#####-#####-!-----!!!!------------------!!----!!!!!!--###-!!----!!----###############################################
################---!!----!!!!!!--!--!!!--!!!!!-----!!-------!!!---!!!--!-----!!!!------------------!!----!!!!!!---!--!!----!!----###############################################
