----------------------------------------------------------------------------------------------------------------
----------------------------------------------------------------------------------------------------------------
----------------------------------------------------------------------------------------------------------------
----------------------------------------------------------------------------------------------------------------
----------------------------------------------------------------------------------------------------------------
-----------------------------------------------------ooooooo-----------oooooooooo-------------------------------
---------------oooooooooooooooo---oooooooooooooooo-----------------BB--B-B-B-B-B--------------------------------
---------------------------------------------------B---------B--------------------------------------------------
--------------------------------B------------------B---------B--------------------------------------------------
----------------------------------------------------------------------------------------------------------------
----------------------------------------------------------------------------------------------------------------
-------------------------------------------------------------------------------------ooo------------------------
----------------------------------------------------------------------------------------------------------------
####-#############################################################################------------------------------
----------------------------------------------------------------------------------------------------------------
