------------------------------------------------------------------------------------------------
------------------------------------------------------------------------------------------------
------------------------------------------------------------------------------------------------
------------------------------------------------------------------------------------------------
---------------B----------------------######----------------------------------------------------
---------------B----------------------B----B----------oooo--------------------------------------
-----------#####----------------------B----B----------####--------------------------------------
----------------------oooooooooo------B----B------------------P---------------------------------
--------------------------------------B----B------oooo------------------------------------------
--------------------B-----------------------------####------------------------------------------
------------B-------B---------------------------------------------------------------------------
------------B-------B-------------------------B-------------#-----------------------------------
------------B------qB--------------q----oo---qB------------##-----------------------------------
######################----##----######--##--####################################################
