--------------------------------------------------------------------------------------------------------------------------------------------------------------------------------
--------------------------------------------------------------------------------------------------------------------------------------------------------------------------------
-------------------------------------------M--------------------------ooo--------------------------------------------------------------------------|----------------------------
---------------------------------------------------------o-----------------------------------------------------------------------------------------|----------------------------
--------------------ooo---------------------------------------------------------------------------------o------------------------------------------|----------------------------
---------------------------------------------------------------------------------------------------------------------------------------------------|----------------------------
-------------------------------------------------------------------ooo-----------------------------------------------------------------------------|----------------------------
------------------------------------------------o-----------------------------------------------o--------------------------------------------------|----------------------------
------------------------ooooo--------------------------------------------o---------------------------------------ooooo-----------------------------|----------------------------
---------------------------------------------------------------------------------------------------------------------------------------------------|----------------------------
---------------------------------------------------------------------------------------------------------------------------------------------------|----------------------------
--------------------------------------ooo----------------------------------------------------------------------------------------------------------|----------------------------
#####----------------------------------------------------------------------------------------------------------------------------------------------|----#####-------------------
################################################################################################################################################################################
################################################################################################################################################################################
