----------------------------------------------------------------------------------------------------------------------------------------------------------------------------------------------------------------------------------------------------------------
----------------------------------------------------------------------------------------------------------------------------------------------------------------------------------------------------------------------------------------------------------------
-----###################################################----------#############################################-------####-----###########################-----#############################p#############################---###################################
--------------------B##########################----------------------------------------------------------------------------------------------------------------################-------------p-##################-------------###################################
--------------------B######################O###----------------------------------------------------------------------------------------------------------------################-------------p-##################-------------###################################
--------------------B##########################---??------------HBB----------------------------------------------------BmB-------------------------------------################-------------p-##################-------------###################################
------------------------------------------------------------------------------[]--------------------------------------------------------------------------------B-------------------[]------p-##################-------------###################################
----------------------------------------------------------------i-------------pP--------------------------------------------------------------------------------B-------------------pP-----{}-##################-------------###################################
----------------------------------------------ggg--------------i-i------------pP-------B--------------------------------------------------------------------------oooooooooo--------pP-----dD-##################-------------###################################
----------------------BBBBBBm##################---??--?M?---------i---------BOpPB*-------------------------[]----------BBBB-------------------[]----------t------mBBBBBBBBBB----#---pP--------##################-------------###################################
----------------------BBBBB--##################-------------------------[]----pP----[]---[]-------------#--pP--##-------------------------[]--pP----------#--------------------##---pP---#######################------[]-----###################################
----------------------BBBBB--##################-------------------------pP----pP----pP---pP------------##--pP--##------------------[]-----pP--pP---------##-------------------###---pP---#######################------pP-----###################################
---------------------------ooo#################------------------------------k-----t----t--------------kk------##------------------------k--------------###----------------kk####--t-----#######################-------------###################################
###########--##--#---###################################------###########################################--##--#------####------################--########-----########################--#######################################################################
###########--##--#---###################################------###########################################--##--#------####------################--########-----########################--#######################################################################
