--------------------------------------------------------------------------------------------------------------------------------------------------------------------------------
--------------------------------------------------------------------------------------------------------------------------------------------------------------------------------
--------------------------------------------------------oo---------------------------------------------------------------------------------------------|------------------------
-------------------------------------------------M----------------------------o------------------------------------------------------------------------|------------------------
---------------------------------------------------------------------------------------------------------oo--------------------------------------------|------------------------
---------------------------------------------------------------------------------o------o-o------------------------------------------------------------|------------------------
--------------------------g----------o----ooo---------------------o---o---o----------------------------------o-----------------------------------------|------------------------
-------------------------------------------------------------------------------------------------------------------------------------------------------|------------------------
-------------------------------------------------------------------------------------------------------------------------------------------------------|------------------------
----------------------------------------------------ooo------------------------------------------------------------------------------------------------|------------------------
------------------------------------------------------------------------------------------------------------o------------------------------------------|------------------------
-------------------------------------------------------------------------------------------------------------------------------------------------------|------------------------
#####--------------------------oo----------------------------------------------------------------------------------------------------------------------|----#####---------------
################################################################################################################################################################################
