--------------------------------------------------------------------------------------------------------------------------------------------------------------------------------
--------------------------------------------------------------------------------------------------------------------------------------------------------------------------------
--------------------------------------------------------------------------------------------------------------------------------------------------------------------------------
-----------------------M--------------------------------------------------------------------------------------------------------------------------------------------------------
--------------------------------------------------------------------------------------------------------------------------------------------------------------------------------
-------------------------------------------------------#------------------------------------------------------------------------BBBBBB------------------------------------------
----------------------------------------------------------------------------------#---------------------------------------------------------------------------------------------
###-------------------###-------------------------------------------------------------------------------------------------------------------------------------------------------
####--------------------------------------------------------------------------------------------------ooo-----------------------------------------------------------------------
#####-------------##-------##--------#####################################------------------------------------------------------------------------------------------------------
--------------------------------##-------------------------------------------------#--------#---------------#--##---------------------------------------------------------------
--------------------------------##-------------------------------------------------#--------#----------#----#--##---------------------------------------------------------------
--------------------------------##-------------------------------------------------#--------#---------ooo---#--##---------------------------------------------------------------
################################################################################################################################################################################
