--------------------------------------------------------------------------------------------------------------------------------------------------------------------------------------------------------------------------------
--------------------------------------------------------------------------------------------------------------------------------------------------------------------------------------------------------------------------------
-------------------123--------------1223---------------------------123--------------1223---------------------------123--------------1223---------------------------123--------------1223--------------|------------123----------
--------123--------123-----12223----1223----------------123--------123-----12223----1223----------------123--------123-----12223----1223----------------123--------123-----12223----1223--------------|-123--------123-----12223
--------123----------------12223------------------------123----------------12223g-g---------------------123----------------12223------------------------123----------------12223----------------------|-123----------------12223
----------------------?---------------------------------------------------------BBBBBBBB---BBB?--------------M-----------BBB----B??B--------------------------------------------------------##--------|-------------------------
-------------------------------------------------------------------------------------------------------------------------------------------------------------------------------------------###--------|-------------------------
------------------------------------------------------------------------------------------------------------------------------------------------------------------------------------------####--------|-------------------------
----------------------------------------------------------------I------------------------------------------------------------------------------------------------------------------------#####--------|----&&&------------------
----------------?---BMB?B---------------------[]---------[]------------------BMB--------------O-----B*----?--?--?-----B----------BB------#--#----------##--#------------BB?B------------######--------|----Q@Q------------------
--8-----------------------------------[]------pP--8------pP---------------------------------------8-------------------------------------##--##----8---###--##--------------------------#######----8---|---&&&&&-----------------
-709-------------8----------[]--------pP------pP-709-----pP------8-------------------------------709-------------8---------------------###--###--709-####--###---8-[]--------------[]-########---709--|---@@N@@--8--------------
70009-g----45556709----4g6------------gg-4556---70009------45556709----456---------------4556---7000gg-----k5556709--gg456-----gg--gg-####55####7000#####--####6709----456-------gg--#########--70009-|---@@N@@6709----456------
#####################################################################--###############---################################################################--#####################################################################
#####################################################################--###############---################################################################--#####################################################################
