------------------------------------------------------------------------------------------------------------------------------------------------------------------------------------------------------------------------------------------------------------------------------------------------------------------------------------------------
------------------------------------------------------------------------------------------------------------------------------------------------------------------------------------------------------------------------------------------------------------------------------------------------------------------------------------------------
------------------------------------------------------------------------------------------------------------------------------------------------------------------------------------------------------------------------------------------------------------------------------------------------------------------------------------------------
------------------------------------------------------------------------------------------------------------------------------------------------------------------------------------------------------------------------------------------------------------------------------------------------------------------------------------------------
------------------------------------------------------------------------------------------------------------------------------------------------------------------------------------------------------------------------------------------------------------------------------------------------------------------------------------------------
------------------------------------------------------------------------------------------------------------------------------------------------------------------------------------------------------------------------------------------------------------------------------------------------------------------------------------------------
----------------------------------------------------------------------------####------------------------------------------------------------------------[]--------------------------------------------------------------------------------------------------------------------------------------------------------------------------------------
###---------------------------------------------------------------------------------------[]------------------------------------------------------------pP----------------------------------------------------------[]--------------------------------------------------------------------------------------------------------------------------
####-----------------------------------------------------------------------------[]-------pP------------------------------------------------------------pP--------------------------------------------------[]------pP--------------[]----------------------------------------------------------------------------------------------------------
#####----------------------------------------------------------------------------pP-------pP----------------------------------------------------------?-##--------------------------------------------------pP------pP--------------pP----------------------------------------------------------------------------------------------------------
---------------------------------------------------------------------------------pP-------pP------------------------------[]------------------[]--------pP--------------------------------------------------pP------pP--------------pP----------------------------------------------------------------------------------------------------------
-------------------[]------------------------------[]----------------------------pP-------pP-----------------------[]-----pP--------[]--------pP--------pP-----------------------------------------[]-------pP------pP--------------pP-----------------------------[]-----[]--------------------------------------------------------------------
-------------------pP------------------------------pP------ggg-------------------pP-------pP-----------------------pP-----pP----t-t-pP-----K-KpP--------pP-K-K-------------------------------------pP-------pP------pP--------------pP-----------------------------pP-----pP-----h--------------------------------------------------------------
################################################################################################################################################################################################################################################################################################################################################
