--------------------------------------------------------------------------------------------------------------------------------------------------------------------------------------------------------------------------------
--------------------------------------------------------------------------------------------------------------------------------------------------------------------------------------------------------------------------------
-&&&-----------------------123---------------123---------------------------123---------------123---------------------------123---------------123---------------------------123---------------123--------|------------------123--
1Q@Q--------------123------1231223-----------1231223--------------123------1231223-----------1231223--------------123------1231223-----------1231223--------------123------1231223-----------1231223----|---------123------12312
&&&&&-------------123---------1223--------------1223--------------123---------1223--------------1223--------------123---------1223--------------1223----k---------123---------1223-------------k1223----|---------123---------12
@@N@@-----------------------------------------------------------------------------I-------*BB------------------BB?BBBMBBB--------BBH------------------B?B--B?B--------------------------------##--------|-----------------------
@@N@@---------------------------------------------------------------------------------------------------------------------------------------------------------------------------------------k###--------|-----------------------
&&&&&&&&&&&&&&&&&&&&&&&&&&&&&&&&&&&&&&&&&&&&&&&&&&&&&&&&&&&&&&&&&&&&&&&&&&&&&&&&&&&&&&&&&&&&&&&&&&&&&&&&&&&&&&&&&&&&&&&&&&&&&&&&&&&&&&&&&&&&g#&&&&&&&&&&&&&&&&&&&&&&&&&&&&k&&&&#&&&&&&&&&&&&####&&&&&&&&|&&&&&&&&&&&&&&&&&&&&&&&
@N@N@@@@@@@@@@@@@@@?@@M@@@@@@@@@@@@@@@@@@@@@@@@@@@@@@@@@@@@@@@@@@@@@@@@@@@@@@@@@@@@@@ggg@@@@@@@@@@@@@@@@@@@@@@@@@h@@@@@@@@@@@@@@@BBB@@@@@@@g##@@@@@@@@@@@@@@@@@@@@@@@@@@@@@@@@@#@@@@@@@@@@@#####@@@@@@@@|@@@@&&&@@@@@@@@@@@@@@@@
@N@N@@@@@@@@@@@@?@@@@@@@@@BBB@@@@@@@@@[]@@@@@@@@@@@@@@@@@@@@@B@@@@@@@@@@@@@@##########@@#@@@@@@@@@@@@@@[]@@@@@@BBBBBBBBBBB@@@@@@@@@@@@@@@@@###@@@@@@@@B?B@@BMB@@@@@@@@BOBBB@@@@#@@@@@@@@@@######@@@@@@@@|@@@@Q@Q@@@@@@@@@@@@@@@@
@@@@@@@@@@@@@@@@@@@@@@@@@@@@@@@@[]@@@@pP@@@@@---@@@@@@@@@[]@@@@@@@@@@@@@@@@##--------#--#@@@@@@@@@@@@@@pP@@@@@@@@@@@@@@@@@@@@@@@----@@@@@@####--@@@@@@@@@@@@@@@@@@@@@@@@@@@@@@##@---@@@@@#######@@@@@@@@|@@@&&&&&@@@@@@@@@@@@@@@
N@N@N@@@@@@@@@@@@@@@@@@@@@@@J@@@pP@@@@pP@@@@@---@@@@@@@@@pP@@@@@@@@[]@@@@@###--------#--##@@@@@@@@@@@@@pP@@@@@@@@@@@@@@@@@@@@@Y@----@@@@@#####--@@@@@@@@@@@@@@@@@@@@@@@@J@@@@@##@---@@@@########@@@@@@@@|@@@@@N@@@@@@@@@@@@@@@@@
N@N@N@@@@@@@@@@@@@@@@@@@@J@@@@@@@@@@@g@@@@@@@---@@@@@@@@ggg@@@@@@k@@@@@@@####,,,,,,,,#,,##@@@@@@@gg@@k@@@@@@@@@@@@@@h@@@@@@@@@y@----@@@@######--@@@@@k@@@@@@@ggg@@@@@J@@@@@J@@##@---@@@#########@@@@@@@@|@@@@@N@@@@@@@@@@@@@@@@@
#############################################---#############################;;;;;;;;#;;########################################----##########--#################################---############################################
#############################################---#############################;;;;;;;;#;;########################################----##########--#################################---############################################
