------------------------------------------------------------------------------------------------------------------------------------------------------------------------------------------------------------------------------------------------
------------------------------------------------------------------------------------------------------------------------------------------------------------------------------------------------------------------------------------------------
---------------------------123---------------123---------------------------123---------------123---------------------------123---------------123---------------------------123---------------123----------------------|----123-&&&-----------123
1223--------------123------1231223-----------1231223--------------123------1231223-----------1231223--------------123------1231223-----------1231223--------------123------1231223-----------1231223--------------123-|----1231Q@Q-----------123
1223--------------123---------1223--------------1223--------------123---------1223--------------1223--------------123---------1223--------------1223--------------123---------1223--------------1223--------------123-|-------&&&&&-------------
------------------------------------------------------------BBBBBBmB-----------------------------------------------BmBBBBBB---------------------------------------------------------------------------------##--------|-------@@N@@-------------
----------------------------------------------------------------------------------------------------------------------------------------------------------------------------------------------------------------------|-------@@N@@-------------
----------------------------------------------------------------------------------------------------------------------------------------------------------------------------------------------------------#-----------|-------&&&&&-------------
-&&&-------------------------------------------------------------h---------------------------------------------------h------------------------------------------------------------------------------------------------|-------@N@N@-------------
-Q@Q-------------------------------------------------[]-----BBBBBBBB---#-------------------------------------##----BBBBBBBB---[]--------------------------------------------------------------O---------#-------------|-------@N@N@-------------
&&&&&--------T-------T------------C--------T---------pP------T---------##------------------T---#-------------##------T--------pP-----------T-----------------T-------T--[]-----------------T-------------------------T|-------@@@@@--------T----
@@N@@------f-T----C--T-ff---------c-----f--T---------pP----f-T---------###------------C-f--T---#-----------f-##------T-ff-----pP--------f--T---------------f-T-------T-fpP--------------f--T-------#--#--------------T|ff-----N@N@N-----f--T----
@@N@@------!-!%%%%c--!-!!-----J---c---%%!%-!---------pP----!-!%h%%-----####-----------c%!%-!-J-#-----------!-##%%%---!-h!-----pP------%%!k-!------h--------!-!%h%%---!-!pP-------h----%%!h-!-------#------------%%---!|!!-----N@N@N---%%!%-!----
#####################################################################--####--###############################################--##--###################################################################-----------################################
#####################################################################--####--###############################################--##--###################################################################-----------################################
