------------------------------------------------------------------------------------------------------------------------------------------------------------------------------------------------------------------------------------------------
------------------------------------------------------------------------------------------------------------------------------------------------------------------------------------------------------------------------------------------------
----------------------------------------------------------------------------------------------------------------------------------------------------------------------------------------------------------------------|-------------------------
----------------------------------------------------------------------------------------------------------------------------------------------------------------------------------------------------------------------|-------------------------
----------------------------------------------------------------------------------------------------------------------------------------------------------------------------------------------------------------------|-------------------------
------------------------------------------------------------BBBBBBBB-----------------------------------------------BBBBBBBB---------------------------------------------------------------------------------##--------|-------------------------
----------------------------------------------------------------------------------------------------------------------------------------------------------------------------------------------------------------------|-------------------------
----------------------------------------------------------------------------------------------------------------------------------------------------------------------------------------------------------#-----------|-------------------------
----------------------------------------------------------------------------------------------------------------------------------------------------------------------------------------------------------------------|-------------------------
-----------------------------------------------------[]-----BBBBBBBB---#-------------------------------------##----BBBBBBBB---[]--------------------------------------------------------------O---------#-------------|-------------------------
-----------------------------------------------------pP----------------##----------------------#-------------##---------------pP----------------------------------------[]--------------------------------------------|-------------------------
-----------------------------------------------------pP----------------###---------------------#-------------##---------------pP----------------------------------------pP-------------------------#--#---------------|-------------------------
#####------------------------------------------------pP----------------####--------------------#-------------##---------------pP---------k------------------------------pP-------------------------#------------------|-------#####-------------
#####################################################################--####--###############################################--##--##############################################################################################################
