------------------------------------------------------------------------------------------------------------------------------------------------------------------------------------------------------------------------------------------------
------------------------------------------------------------------------------------------------------------------------------------------------------------------------------------------------------------------------------------------------
------------------------------------------------------------------------------------------------------------------------------------------------------------------------------------------------------------------------|-----------------------
---------------------l--------------------------------------------------------------------------------------------------------------------------------------------------------------------------------------------------|-----------------------
-------------------------J----------------------------------------------------------------------------------------------------------------------------------------------------------------------------------------------|-----------------------
------------------------##-----------------B+BBBBBBBBBBBBBBBBBBBBBBBBBBBBBBB----------------------------------------------------------------------------------------------------------------------------------##--------|-----------------------
-----------------------###------------------------------------------------------------------------------------------------------------------------------------------------------------------------------------##--------|-----------------------
----------------------####----------------------------------------------------------------------------------------------------------------------------------------------------------------g----------------J--##--------|-----------------------
----------------------####---------------------------------------------------------------------------------------------C------------------------------------------------------------------#----------------#--##--------|-----------------------
--------------------#-####---????--------------------------------------------BB--------------------Bm---------BB------B#O-----------------------------------[]--------------------------g##----------------#--##--------|-----------------------
-----------------J-##-####-------------------------------------------------------------------C-------------------------------C------------------------------pP-----------------J--------###----C---------#-#--##--------|-----------------------
------------------###-####------------------Y----------------------------------------C-------c-----------C-------------------c-----[]---------[]------------pP-----[]----------C-------####----c--------##-#--##--------|-----------------------
-----------------####-####------------------y------------J--------J--J---------------c------JC-J---------c-----t---C-----t-t-c-------------J------------------------------J-J--c------#####--t-C-------###-#--##--------|-----------------------
###############-#####-##############-########-####-#-###-######-##############--####-#####################################################-#####-#-#------####################-#---#######################-#--##################################
###############-#####-##############-########-####-#-###-######-##############--####-#####################################################-#####-#-#------####################-#---#######################-#--##################################
