----------------------------------------------------------------------------------------------------------------------------------------------------------------------------------------------------------------
----------------------------------------------------------------------------------------------------------------------------------------------------------------------------------------------------------------
###################################################################################################################################################-----########################################################
######-----------------------------------------------------------------------###-----------------------------------------------------------------##---------------------------##--------------------------------
######-----------------------------------------------------------------------###-----------------------------------------------------------------##---------------------------##--------------------------------
-----------------------------------------------------------------------------###----------------------------------------------------------------#-----------------------------##--------------------------------
------------------######-#-#-#-#-#-########################################--------------------###--####-###--###################################---------------------------------------------------------------
###---------------######-#-#-#-#-#-###------###############################------------------#-#---------#--------------------------------------#---------------------------------------------------------------
####--------------######-#-#-#-#-#-###------###############################--------------##---#----------#--------------------------------------#---------------------------------------------------------------
#####-------------######-#-#-#-#-#-###------###############################-------------------#----------#--------------------------------------#----------------------w-----###--------------------------------
#######--##--###------------------------[]-----------------------------------###------##--#####-################################################--------####--##=============###--------------------------------
#######--##--###------------------------pP-----------------------------------###----------#-------------------------------------------------------------####--##-------------###--------------------------------
#######--##--###------------------------pP-----------------------------------###----------#-------------------------------------------------------------####--##-------------###--------------------------------
#######^^##^^###########################################################################^^#^^^^#################################################################^^^^^^^^^^^^^###################################
#######::##::###########################################################################::#::::#################################################################:::::::::::::###################################
