------------------------------------------------------------------------------------------------------------------------------------------------------------------------------------------------------------------------------------------------
------------------------------------------------------------------------------------------------------------------------------------------------------------------------------------------------------------------------------------------------
------------------------------------------------------------------------------------------------------------------------------------------------------------------------------------------------------------------------------------------------
------------------------------------------------------------------------------------------------------------------------------------------------------------------------------------------------------------------------------------------------
------------------------------------------------------------------------------------------------------------------------------------------------------------------------------------------------------------------------------------------------
------------------------------------------------------------------------------------------------------------------------------------------------------------------------------------------------------------------------------------------------
-------------------------------------------------------###########----------------------####-------##-###-####--------###--#######--###--################---------------------------------------------------------------------------------------
###----------------------------------#--------------------------------------------------##-------------#---------------------------------#------------------------------------------------------------------------------------------------------
####--------------------------------##--------------------------------------------------#------------------------------------------------#------------------------------------------------------------------------------------------------------
#####-----------------------------####---------------------------------------------------------------------------------------------------#------------------------------------------------------------------------------------------------------
------------------------------------------------------#############----------------------------------------------------###--#######--###--------------------------------------------------------------------------------------------------------
--------------------------------------------------------------------------------------------------------------------------------------------#---------------------------------------------------------------------------------------------------
-------------------------------------------------------------------------------------------------------------------------------------------##---------------------------------------------------------------------------------------------------
################################################################################################################################################################################################################################################
