--------------------------------------------------------------------------------------------------------------------------------------------------------------------------------------------------------------------------------
--------------------------------------------------------------------------------------------------------------------------------------------------------------------------------------------------------------------------------
--------------------------------------------------------------------------------------------------------------------------------------------------------------------------------------------------------|-----------------------
--------------------------------------------------------------------------------------------------------------------------------------------------------------------------------------------------------|-----------------------
--------------------------------------------------------------------------------------------------------------------------------------------------------k--------------------------------------k--------|-----------------------
----------------------------------------------------------------------------------+-------*BB------------------BB?BBBMBBB--------BBB------------------B?B--B?B--------------------------------##--------|-----------------------
--------------------------------------------------------------------------------------------------------------------------------------------------------------------------------------------k###--------|-----------------------
--------------------------------------------------------------------------------------------------------------------------------------------g#----------------------------k----#------------####--------|-----------------------
-------------------?--M--------------------------------------------------------------ggg-----------------------------------------BBB-------g##---------------------------------#-----------#####--------|-----------------------
----------------?---------BBB---------[]---------------------B--------------#--------#--#--------------[]------BBBBBBBBBBB-----------------###--------B?B--BMB--------BOBBB----#----------######--------|-----------------------
--------------------------------[]----pP-----------------[]----------------##--------#--#--------------pP---------------------------------####--------------------------------##---------#######--------|-----------------------
--------------------------------pP----pP-----------------pP--------[]-----###--------#--##-------------pP---------------------B----------#####--------------------------------##--------########--------|-----------------------
#####---------------------------pP---gpP----------------ggg------k-pP----####--------#--##-------gg--k-pP-------------------------------######-------k-------ggg--------------##-------#########--------|---#####---------------
#############################################---#############################--------#--########################################----##########--#################################---############################################
