--------------------------------------------------------------------------------------------------------------------------------------------------------------------------------------------------------------------------------
--------------------------------------------------------------------------------------------------------------------------------------------------------------------------------------------------------------------------------
-----------------------------------------------------------------------------------------------------------------------------------#--------------------------------------------------------------------------------------------
-----------------------------------------------------------------------------------B-----------------------------------------------#-----------------------------------------B--------------------------------------------------
-----------------------------------------------------------------------------------B----------q------------------------------------#########---------------------------------B--------------------------------------------------
---------------------------ooo----------------------------------------------------###-----------------B-----------------------------------------------------###---###-------#####---####----------------------------------------
------------------------------------------------------------------------------------------------------B----------ooo----------------------------------------#-------#-----------------------------------------------------------
------------------------------------------B----------------------------------q------------------------B-----------------------------------------------------#-------#------------------------P----------------------------------
-------------------------q-------B--------B---------q------------#-----#------------------------------B------------##---------------------------------------#-------#-----------------------------------------------------------
------------------###------------B--------##------B--------------#-----q-----------q------------------##----------------B--------#-----------#--------q-----#--ooo--#-------#####---####----------------------------------------
-----------B---------------------B------------q---B-------------##-ooo-##----------------B------------------------------B--------#-----------#-------B------#-------#----------------------#------------------------------------
-----------B---------------------B----------------B----q--------##-----##----------------B-----------ooo----------------B--------##--o---o--##-----B-B------#-------#---------------------##------------------------------------
-----------B--oo------q----------B--ooo-----------B-------------##-----##----------------Bq--------------q--------------B--------##---ooo---##-----B-B------#--ooo--#--------q-----q-----###------------------------------------
##################################################################-----############################################################---------#################-------############################################################
##################################################################-----############################################################---------#################-------############################################################
