------------------------------------------------------------------------------------------------
------------------------------------------------------------------------------------------------
--------------------------##----##---------------------------###################################
--------------------------##----##---------------------------###################################
---------------B----------##----##----######-----------------###################################
---------------B----------------------B----B----------oooo---###################################
-----------#####----------------------B----B----------####----##################################
----------------------oooooooooo------B----B------------------{#################################
--------------------------------------B----B------oooo--------d#################################
--------------------B-----------------------------####-------###################################
------------B-------B-----##----##---------------------------###################################
------------B-------B-----##----##------------B-------------####################################
------------B------qB-----##----##-q----oo---qB------------#####################################
######################----##----######--##--####################################################
######################----##----######--##--####################################################
