--------------------------------------------------------------------------------------------------------------------------------------------------------------------------------------------------------------------------------
--------------------------------------------------------------------------------------------------------------------------------------------------------------------------------------------------------------------------------
------------------------------------------------------------------------------------------------------------------------------------------------------------------------------------------------------|-------------------------
------------------------------------------------------------------------------------------------------------------------------------------------------------------------------------------------------|-------------------------
--------------------------------------------------------------------------------g-g-------------------------------------------------------------------------------------------------------------------|-------------------------
----------------------?---------------------------------------------------------BBBBBBBB---BBB?--------------M-----------BBB----B??B--------------------------------------------------------##--------|-------------------------
-------------------------------------------------------------------------------------------------------------------------------------------------------------------------------------------###--------|-------------------------
------------------------------------------------------------------------------------------------------------------------------------------------------------------------------------------####--------|-------------------------
----------------------------------------------------------------I------------------------------------------------------------------------------------------------------------------------#####--------|-------------------------
----------------?---BMB?B---------------------[]---------[]------------------BMB--------------O-----B*----?--?--?-----B----------BB------#--#----------##--#------------BB?B------------######--------|-------------------------
--------------------------------------[]------pP---------pP-----------------------------------------------------------------------------##--##--------###--##--------------------------#######--------|-------------------------
----------------------------[]--------pP------pP---------pP----------------------------------------------------------------------------###--###------####--###-----[]--------------[]-########--------|-------------------------
------g-----------------g-------------gg------------------------------------------------------------gg-----k---------gg--------gg--gg-####--####----#####--####------------------gg--#########--------|-------------------------
#####################################################################--###############---################################################################--#####################################################################
#####################################################################--###############---################################################################--#####################################################################
