--------------------------------------------------------------------------------------------------------------------------------------------------------------------------------------------------------------------------------
--------------------------------------------------------------------------------------------------------------------------------------------------------------------------------------------------------------------------------
#-----###################################################################################+################################################-----------------------#######pP#################---##################################
#-----------------------------------------------------##--######--####------####----------------------------------------------------------------------------------------pP#######-------------##################################
#-----------------------------------------------------##-g######--####------####----------------------------------------------------------------------------------------pP#######-------------##################################
#----------------------------------------oooo-------##--------##---B----BB----------oooooo------------------------------------------------------------------------------pP#######-------------##################################
#---------------------------------------------------##--------##---B----BB----------------------------------------------------------------------------------------------pP#######-------------##################################
#--------------------------------------B-BBBB-*-----##--------##---B----BB----------BBBBBB------------------------------------------------------------------------------pP#######-------------##################################
#----------------------------O---------BoB--BoB-----##----oooo##gg-Bom--BO----------BBBBBB-------------------------------------------------------BBBBBm---gg----------{}(P#######-------------##################################
#---------M????--------#-#-------------BBB--BBB-----##BB--BBBB##---BBB--BB--BBBB-----------------------------[]-------------------------##------------------------r---dD)P#######-------------##################################
#--------------------#-#-#-#---#----------------------BB-----------------------------------------------[]----pP-----------BB-----------###----------------------B################-[]--[]--[]--##################################
#----------------g-#-#-#-#-#---#-#--------------------BB-----------------------------------------------pP----pP----[]-----BB----------####----------------------B################-pP--pP--pP--##################################
#---------------g#-#-#-#-#-#-g-#k#k--------k--g-g------------------------------------------------------pP----pP----pP-gg-gBB-----g---#####----------------------B################-pP--pP--pP--##################################
################################################################################---#####################################--##--############-------########-------################################################################
################################################################################---#####################################--##--############-------########-------################################################################
