------------------------------------------------------------------------------------------------------------------------------------------------------------------------------------------------------------------------------------------------
------------------------------------------------------------------------------------------------------------------------------------------------------------------------------------------------------------------------------------------------
------------------------------------------------------------------------------------------------------------------------------------------------------------------------------------------------------------------------|-----------------------
------------------------------------------------------------------------------------------------------------------------------------------------------------------------------------------------------------------------|-----------------------
---------------------------------------------------gg-------------------------------------------------------------------------------------------------------------------------------------------------------------------|-----------------------
-----------------------BOB-----------------------------------------BBBBB-----BBBBB---------------------------------B---BBBBBBBBB------------*B---BB-------------BBB-------------------------------------------##--------|-----------------------
--------------------------------[]-----------------------------------------------------------------------------[]------------------------------------------------------[]------------------------------------###--------|-----------------------
--------------------------------pP----------------------------[]-----------------------[]----------------------pP------------------------------------------------------pP-----------------------------------####--------|-----------------------
--------------------------------##----------------------[]----pP-----------------------pP----------------------pP-------------------------BB---------------------------pP----------------------------------#####--------|-----------------------
----------BBB------[]---?---[]--pP------------[]---BB---pP----##------------------?----pP-------------[]------B##B------------------------------BBB---------#---BBB----##-----[]-------[]----------------[]#####--------|-----------------------
-------------------pP-------pP--pP------------pP--------pP----pP----------------[]-----pP-----[]------pP-------pP--------------------------------------#-[]-#----------pP-----pP-----[]pP----[]----------pP#####--------|-----------------------
-------------------pP-------pP--pP-[][]-------pP--------pP----pP---[]-----[]----pP--[]-pP-----pP------pP-[]----pP--[]--------------[]--[]-------------##-pP-##---------pP-----pP---[]pPpP----pP---------#pP#####--------|-----------------------
#####-----k--------pP-------pP--pP-pPpP-------pP--------pP----pP---pP-----pP----pP--pP-pP-----pP------pP-pP----pP--pP--------------pP--pP------------###-pP-##---------pP---ggpP---pPpPpP----pP--------##pP#####--------|---#####---------------
###########################################################################################################################------############-#-########-#######################################################################################
