----------------------------------------------------------------------------------------------------------------------------------------------------------------------------------------------------------------------------------------------------------------------------------------------------------------------------------------------------------------------------------------------------------------
----------------------------------------------------------------------------------------------------------------------------------------------------------------------------------------------------------------------------------------------------------------------------------------------------------------------------------------------------------------------------------------------------------------
-&&&-----------------------123---------------123---------------------------123---------------123---------------------------123---------------123---------------------------123---------------123---------------------------123---------------123---------------------------123---------------123---------------------------123---------------123---------------------------123----------|----123----------------
1Q@Q--------------123------1231223-----------1231223--------------123------1231223-----------1231223--------------123------1231223-----------1231223--------------123------1231223-----------1231223--------------123------1231223-----------1231223--------------123------1231223-----------1231223--------------123------1231223-----------1231223--------------123------1231223------|----1231223------------
&&&&&-------------123---------1223--------------1223--------------123---------1223--------------1223---------oo---123---------1223--------------1223--------------123---------1223--------------1223--------------123---------1223--------------1223--------------123---------1223--------------1223--------------123---------1223--------------1223--------------123---------1223------|-------1223------------
@@N@@-----------------------------------------------------------------------------------------------------------------------------------------------------BBBBOBBB------------------------------------------------------------------------------------------------------------------------------------------------------------------------------------------------------------##--------|-----------------------
@@N@@-------------------------------------------------------------------------------------------------------------------------------------------------------------------------------------------------------------------------------------------------------------------------------------------------------------------------------------------------------------------------##--------|-----------------------
&&&&&&&&&&&&&&&&&&&&&&&&&&&&&&&&&&&&&&&&&&&&&&&&&&&&&&&&&&&&&&&&&&&&&&&&&&&&&&&&&&&&&&&&&&&&&&&&&&&&&&&&&&&&&&&&&&&&&&&&&&&&&&&&&&&&&&&&&&&&&&&&&&&&&&&&&&&&&&&&&&&&&&&&&&&&&&&&&&&&&&&&&&&&&&&&&&&&&&&&&&&&&&&&&&&&&&&&&&&&&&&&&&&&&&&&&&&&&&&&&&&&&&&&&&&&&&&&&&&&&&&&&&&&&&&&&&&&&&&&#&&&&&&&&&&&&&&&&&&&&&&&&&&&&&&&&&&&&&&&&&&&&&&&&&&&&&&&&&&&&&&&&&&&&&&&&&&&&&&&&&&&#&##&&&&&&&&|&&&&&&&&&&&&&&&&&&&&&&&
@N@N@@@@@@@@@@@@@@@@@@@@@@@@@@@@@@@@@@@@@@@@@@@@@@@@@@@@@@@@@@@@o@@@@@@@@@@@@@@@I@@@@@@@@o@@@@@@@@o@@@@@@@@@@@@@@@@@@@@@@@@@@@@@@@@@@@@@@@@@@@@@@@@@@@@@@@@@@@@@@@@@@@@@@@@@@@@@@@@@@@@@BB*BBBBB@@@@@@@@@@@@@@@@@@@@@@@@@@@@@@@oo@@@@@@@@@@@@@@@@@@@@@[]@@@@@@@@@@@@@@@@@@@@@@@@@@@@@@@##@@oo@@@@@@o@@@@o@@@@@@@@@@@@@@@@@@@oo@@@oo@@@@@@@@@@@@@@@@@@@@@@@@@@@@@@@@@@@@@@@@@#@##@@@@@@@@|@@@@&&&@@@@@@@@@@@@@@@@
@N@N@@@@@@@@@@@@@@@@@@@@@@@@@@@@@@@[]@@@@@@@@@@@@@@@@@@@@@@@@@@@@@@@@@@@@@@@[]@@@@@@@@@@@@@@@@[]@@@@@@@@[]@@@@@@@@@@@@@@@@@@@@@@@@@@@@@@@@@@@@@@@@@@@@@@@#@@@@i@@@@#@@@@@@@@@@@@@@@@@@@@@@@@@@@@@@@@@@@@@@@@@@@@@@@@@@@@@@@@@@@@@@@@@@@@@@@@@@@@@@[]@@pP@@@@@@@@@@@@@@@@@@@@@@@@@@@@@@###@@@@@@@@@@@@@@@@@@@@@@@@@@@@@@@@@@@@@@@@@@@@@@@@@@@@@@@@@@@@@@@@@@@@@@@@@@@@@@@@@#@#@##@@@@@@@@|@@@@Q@Q@@@@@@@@@@@@@@@@
@@@@@@@@@@@@@@@@@@@@@@@@@@@@@@@@@@@pP@@@@@@@@@-@-@@-@@-@@-@@@@@@@@@@@@@@@@@@pP@@@@[]@@@@@@@@@@pP@@@@@@@@pP@@@@@@@@@@@@@@@@@@@@@@@@@@@@@@@@@@[]@@@@@@@@@@@#@@@@@@@@@#@@@@@-@-@@-@-@@-@@@@@@@@@@@@@@@@@-@-@-@@@@@@@@@@@@@@@@@@@------@@@@@@@@@@-[]--pP--pP@@@@@@@@@@@@@@@@@@@@@@@@@@@@@####@@@@@@@@@---@@---@@@@@@@@@@@@@@@@-----@----@@@@@@@@@@@@@@@@@@@@[]@@@@@@@@@@@@@-@-#-#-##@@@@@@@@|@@@&&&&&@@@@@@@@@@@@@@@
N@N@N@@@@@@@@@@@@@@@@@@@@@@@@@@@@@@pP@@@@@@@@@-@-@@-@@-@@-@@@@@@@@@@@@@@@@@@pP@@@@pP@@@@@@@@@@pP@@@@@@@@pP@@@@@@@@@[]@@@@@@@@@@@@@@@@@@@@@@@pP@@@@@@@@@@@#@@@@@@@@@#@@@@@-@-@@-@-@@-@@@@@@@@@@@@@@@@@-@-@-@@@@@@@@#@@@@@@@@@@------@@@@@@@@@@-pP--pP--pP@@@@@@@@@@@@@@@@@@@@@@@@@@@@#####@@@@@@@@@---@@---@@@@@#@@@#@@@@@@-----@----@@@@@@@@@@@@@@@@@@@@pP@@@@@@@@@[]@@-#-#-#-##@@@@@@@@|@@@@@N@@@@@@@@@@@@@@@@@
N@N@N@@@@@@@@@@@@@t@@@@@@@ggg@@@@ggg@@@@@@@@@@kk-@@-@@-@@-@@@k@@@@@@@@@@ggg@@@@@@t@@@@@@@@@@@@@@@@@@@@@@@@@@@@@ggg@@@@@k@@@@@@@kkk@@@kkk@@@@@@@@@@@@@@@ggg@@@@@@@J@#@@@@@-@-J@-@-J@-@@@@@@@@@@@@@@@@@-@-@-@@@@@@@@kk@@@@@@@@@------@@@@@@@@ggg@@--@@--@@@@@@@@t@@@@@ggg@@@@ggg@@@@@gg####@@t@@@@@@---@@---@@@@@#@k@#@@@@@@-----@----@@@@@@@@k@@@@@@@@@kkk@@@@@@@@@@@@@@-#-#-#-##@@@@@@@@|@@@@@N@@@@@@@@@@@@@@@@@
##############################################-#-##-##-##-###############################################################################################################-#-##-#-##-#################-#-#-###################------##########-##--##--############################################---##---################-----#----###################################-#-#-#-##################################
##############################################-#-##-##-##-###############################################################################################################-#-##-#-##-#################-#-#-###################------##########-##--##--############################################---##---################-----#----###################################-#-#-#-##################################
