----------------------------------------------------------------------------------------------------------------------------------------------------------------------------------------------------------------------------------------------------------------------------------------------------------------------------------------------------------------------------------------------------------------
----------------------------------------------------------------------------------------------------------------------------------------------------------------------------------------------------------------------------------------------------------------------------------------------------------------------------------------------------------------------------------------------------------------
----------------------------------------------------------------------------------------------------------------------------------------------------------------------------------------------------------------------------------------------------------------------------------------------------------------------------------------------------------------------------------------|-----------------------
----------------------------------------------------------------------------------------------------------------------------------------------------------------------------------------------------------------------------------------------------------------------------------------------------------------------------------------------------------------------------------------|-----------------------
-------------------------------------------------------------------------------------------------------------oo-------------------------------------------------------------------------------------------------------------------------------------------------------------------------------------------------------------------------------------------------------------------------|-----------------------
----------------------------------------------------------------------------------------------------------------------------------------------------------BBBBOBBB------------------------------------------------------------------------------------------------------------------------------------------------------------------------------------------------------------##--------|-----------------------
------------------------------------------------------------------------------------------------------------------------------------------------------------------------------------------------------------------------------------------------------------------------------------------------------------------------------------------------------------------------------##--------|-----------------------
----------------------------------------------------------------------------------------------------------------------------------------------------------------------------------------------------------------------------------------------------------------------------------------#-----------------------------------------------------------------------------------#-##--------|-----------------------
----------------------------------------------------------------o---------------I--------o--------o-------------------------------------------------------------------------------------BB*BBBBB-------------------------------oo---------------------[]-------------------------------##--oo------o----o-------------------oo---oo-----------------------------------------#-##--------|-----------------------
-----------------------------------[]---------------------------------------[]----------------[]--------[]-----------------------------------------------#----i----#------------------------------------------------------------------------------[]--pP------------------------------###---------------------------------------------------------------------------------#-#-##--------|-----------------------
-----------------------------------pP---------------------------------------pP----[]----------pP--------pP----------------------------------[]-----------#---------#--------------------------------------------------------------------------[]--pP--pP-----------------------------####---------------------------------------------------------------[]----------------#-#-##--------|-----------------------
-----------------------------------pP---------------------------------------pP----pP----------pP--------pP---------[]-----------------------pP-----------#---------#----------------------------------------------#---------------------------pP--pP--pP----------------------------#####----------------------#---#------------------------------------pP---------[]---#-#-#-##--------|-----------------------
------------------t-------ggg----ggg----------kk-------------k----------ggg------t-----------------------------ggg-----k-------kkk---kkk---------------ggg-------K-#--------K----K--------------------------------kk-----------------------ggg----------------t-----ggg----ggg-----gg####--t-------------------#-k-#------------------------k---------kkk---------------#-#-#-##--------|-----------------------
##############################################-#-##-##-##-###############################################################################################################-#-##-#-##-#################-#-#-###################------##########-##--##--############################################---##---################-----#----###################################-#-#-#-##################################
##############################################-#-##-##-##-###############################################################################################################-#-##-#-##-#################-#-#-###################------##########-##--##--############################################---##---################-----#----###################################-#-#-#-##################################
