------------------------------------------------------------------------------------------------------------------------------------------------------------------------------------------------------------------------------------------------
------------------------------------------------------------------------------------------------------------------------------------------------------------------------------------------------------------------------------------------------
-------------------123--------------1223---------------------------123--------------1223---------------------------123--------------1223---------------------------123--------------1223---------------------------123--|-----------1223--------
--------123--------123-----12223----1223----------------123--------123-----12223----1223----------------123--------123-----12223----1223----------------123--------123-----12223----1223----------------123--------123--|--12223----1223--------
--------123----------------12223-------------------gg---123----------------12223------------------------123-------------t--12223------------------------123----------------12223------------------------123---J---------|--12223----------------
-----------------------BOB-----------------------------------------BBBBB-----BBBBH---------------------------------B---BBBBBBBBB------------*B---BB-------------BBB-------------------------------------------##--------|-----------------------
--------------------------------[]-----------------------------------------------------------------------------[]------------------------------------------------------[]------------------------------------###--------|-----------------------
--------------------------------pP----------------------------[]-----------------------[]----------------------pP------------------------------------------------------pP-----------------------------------####--------|-----------------------
-&&&----------------------------##----------------------[]----pP-----------------------pP----------------------pP-------------------------BB---------------------------pP----------------------------------#####--------|----&&&----------------
-Q@Q------BBB------[]---i---[]----------------[]---Bm---pP----##------------------i----pP-------------[]------B##B------------------------------BBB---------#---BBB----##-----[]-------[]----------------[]#####--------|----Q@Q----------------
&&&&&--------------pP-------pP----------------pP--8-----pP----------------------[]-----pP-----[]--8---pP------------------------------------------8----#-[]-#-----------------pP-----[]pP----[]---8------pP#####--------|---&&&&&---------------
@@N@@------------8-pP-------pP-----[][]-------pP-709----pP-------8-[]-----[]----pP--[]-pP-----pP-709--pP-[]------8-[]--------------[]--[]--------709--##-pP-##---8------------pP---[]pPpP----pP--709----#pP#####-8------|---@@N@@---------------
@@N@@------45556709pP--456-JpP-----pPpPt-4556-pP70009---pP-4t556709pP--456pP----pP--pP-pP4556-pP70009-pP-pP45556709pP--456---------pP--pP4556---70009###-pP4##56709t---456--ggpP---pPpPpP4556pP-70009--##pP#####709----4|6--@@N@@--------4556---
###########################################################################################################################------############-#-########-#######################################################################################
###########################################################################################################################------############-#-########-#######################################################################################
