--------------------------------------------------------------------------------------------------------------------------------------------------------------------------------
--------------------------------------------------------------------------------------------------------------------------------------------------------------------------------
-------------------------------------------M--------------------------ooo--------------------------------------------------------------------------|----------------------------
------------------------------------R--------------------o------------###--------------------------------------------------------------------------|----------------------------
--------------------ooo---------###-------------------------------------------r-------------------------o------------------------------------------|----------------------------
-------------------#####---------------#####------------------------------#####--------------------------------------------------------------------|----------------------------
-------------------------------------------------------------------ooo-----------------------------------------------###---------------------------|----------------------------
------------------------------------------------o------------------###--------------------------o--------------------------------------------------|----------------------------
------------------------oooorr---------------------###-------------------o---------------------------------------ooooo-----------------------------|----------------------------
-----------------------#######--------------###-------------------------###---------###--------------------------#####-----------------------------|----------------------------
---------------------------------------------------------------------------------------------------------###----------------------#####------------|----------------------------
--------------------------------------oro----------------------------------------------------------###---------------------------------------------|----------------------------
------------------------------------#######-------------------------r------------------------------------------------------------------------------|----------------------------
##############--#####--------------------------------------------#####---------------------------------------------------#######------------####################################
##############------------------------------------------------------------------------------------------------------------------------------####################################
