--------------------------------------------------------------------------------------------------------------------------------------------------------------------------------------------------------------------------------
--------------------------------------------------------------------------------------------------------------------------------------------------------------------------------------------------------------------------------
-----------------------------------------------------------------------------------------------------------------------------------#--------------------------------------------------------------------------------------------
-----------------------------------------------------------------------------------B-----------------------------------------------#-----------------------------------------B--------------------------------------------------
-----------------------------------------------------------------------------------B-----------------------------------------------#########---------------------------------B--------------------------------------------------
---------------------------ooo----------------------------------------------------###-----------------B-----------------------------------------------------###---###-------#####---####----------------------------------------
------------------------------------------------------------------------------------------------------B----------ooo----------------------------------------#-------#-----------------------------------------------------------
------------------------------------------B-----------------------------------------------------------B-----------------------------------------------------#-------#------------------------P----------------------------------
---------------------------------B--------B----------------------#-----#------------------------------B------------##---------------------------------------#-------#-----------------------------------------------------------
------------------###------------B--------##------B--------------#-----#------------------------------##----------------B--------#-----------#--------------#--ooo--#-------#####---####----------------------------------------
-----------B---------------------B----------------B-------------##-ooo-##----------------B------------------------------B--------#-----------#-------B------#-------#----------------------#------------------------------------
-----------B---------------------B----------------B-------------##-----##----------------B-----------ooo----------------B--------##--o---o--##-----B-B------#-------#---------------------##------------------------------------
-----------B--oo-----------------B--ooo-----------B-------------##-----##----------------B------------------------------B--------##---ooo---##-----B-B------#--ooo--#--------------------###------------------------------------
##################################################################-----############################################################---------#################-------############################################################
