----------------------------------------------------------------------------------------------------------------------------------------------------------------------------------------------------------------------------------------------------------------
----------------------------------------------------------------------------------------------------------------------------------------------------------------------------------------------------------------------------------------------------------------
-&&&---------------123--------------1223---------------------------123--------------1223---------------------------123--------------1223---------------------------123--------------1223---------------------------123-----------|--1223------------------------
-Q@Q----123--------123-----12223----1223----------------123--------123-----12223----1223----------------123-----l--123-----12223----1223----------------123--------123-----12223----1223---------l------123--------123-----12223-|--1223----------------123-----
&&&&&---123----------------12223------------------------123----------------12223------------------------123----------------12223------------------------123----------------12223------------------------123----------------12223-|----------------------123-----
@@N@@--------------------?--------------------------------------?-?-------------------------I-------------------------------------------------------????---------------------------------------------------------------##--------|------------------------------
@@N@@----------------------------------------------------------------------------------------------------oooo----------oooo------------oooo---------------------------------------------------------------------------###--------|------------------------------
&&&&&&&&&&&&&&&&&&&&&&&&&&&&&&&&&&&&&&&&&&&&&&&&&&&&&&&&&&&&&&&&&&&&&&&&&&&&&&&&&&&&&&&&&&&&&&&&&&&&&&&&&&&&&&&&&&&&&&&&&&&&&&&&&&&&&&&&&&&&&&&&&&&&&&&&&&&&&&&&&&&&&&&&&&&&&&&&&&&&&&&&&&&&&&&&&&&&&&&&&&&&&&&&&&&&&####&&&&&&&&|&&&&&&&&&&&&&&&&&&&&&&&&&&&&&&
@N@N@@@@@@@@@@@@@@@@@@@@@@@@@@@@@@@@@@@@@@oo@@@@@@@@@@@@@@@@@@@@@@@@@@@@@@@@@@@@@@@@@@@@@@@@@@@@@@@@@@@@@@@@@@@@@@@@@@@@@@@@@@@@@@@@@@@@@@@@@@@@@@@@@@@@@@@@@@@@@@@@@@@@@@@@@@@@@@@@@@@@@@@@@@@@@@@@@@@@@@@@@@@@@@@@#####@@@@@@@@|@@@@&&&@@@@@@@@@@@@@@@@@@@@@@@
@N@N@@@@@@@@@@@@@@@@@@@@@M@@@@@@@@@@@@@@@o@@o@@@@@@@@@@@@@@@@@@@?@?@@@@@@@@@@@@@@@@@@@@@@@????@@@@@@@@@@@@@@@@@@@@@@[]@@@@@@@@@@@@@@[]@@@@@@@@@@@@??MBB???@@@@@@@@@@@@@@@@@@@@@@@@@@@@@@@@@@@@@@@@@@@@@@@@@@@@@@@@@######@@@O@@@@|@@@@Q@Q@@@@@@@@@@@@@@@@@@@@@@@
@@@@@@@@@@@@@@@@@@@@@[]@@@@@@@@@--@@@@@@@@@@@@@@@@@@@@@@@@@@@@@@@@@@@@@@@@@@@@----@@@@@@@@@@@@@@@@@@@@@#@@@@@@@@@@@@pP@@@@@@@@@@@@@@pP@@@@@@@@@@@@@@@--@@@@@@@@@@@@@@@@@@@@@@@---@@@--@@@@@@@#--@@@@@@@@@@@@@@@@@@#######@@@@@@@@|@@@&&&&&@@@@@@@@@@@@@@@@@@@@@@
N@N@N@@@@@@@@@@@@@@@@pP@@@@@@@@@--@@@@@@@@@@@@@@@@@@@@@@@@@@@@@@@@@@@@@@@@@@@@----@@@@@@@@@@@@@@@@@@@@@#@@@@@@@@@@@@pP@@@@@@@@@@@@@@pP@@@@@@@@@@@@@@@--@@@@@@@@@@@@[]@@@@@@@@@---@@@--@@@@@@@#--@@@@@@@@@@@@@@@@@########@@@@@@@@|@@@@@N@@@@@@@@@@@@@@@@@@@@@@@@
N@N@N@@@@@@@@@@@@@@@@pP@@@@@@@@@--@@@@@@@@@@@@@@@@@@@@@@@@@@@@@@@@@@@@@@@@@@@@----@@@@@@@@@@@@@@@@@@@@@#@@@@@@@@@@@@pP@@@@@@@@@@@@@@pP@@@@@@@@@@@@@@@--@@@@@@@@@@@@pP@@@@@@@@@---@@@--@@@@@@@#--@@@@@@@@@@@@@@@@#########@@@@@@@@|@@@@@N@@@@@@@@@@@@@@@@@@@@@@@@
################################--############################################----###################################################################--#######################---###--########--################################################################
################################--############################################----###################################################################--#######################---###--########--################################################################
