------------------------------------------------------------------------------------------------------------------------------------------------------------------------------------------------
------------------------------------------------------------------------------------------------------------------------------------------------------------------------------------------------
----------------------------oo-------------------------------------------------------ooo-------------------------------------------------------------------------------|------------------------
-------------------------------------------------------M--------------------------------------------------------------------------------------------------oo-----------|------------------------
-------------------------------------------ooooooo---------------------------------------------------------------------------------------------------------------------|------------------------
-------------------------------------------------------------------------oo-----------------------------------------------------oo-------------------------------------|------------------------
-----------------------------------------------------------------------------------------------------------------------------------------------------------------------|------------------------
-------------------------------------------------------------------------------------------------------------------------------------------------oo--------------------|------------------------
----------------------------------------------------------------------------------------------------oooo---------------------------------------------------------------|------------------------
-----------------------------------------------------------------------------------------------------------------------------------------------------------------------|------------------------
-----------------------------------------------------------------------------------------------------------------------------------------------------------------------|------------------------
--------------------------------------B-----------------------------------------------------------------------------B--------------------------------------------------|------------------------
#####------------------------------------------------------------------------------------------------------------------------------------------------------------------|----#####---------------
################################################################################################################################################################################################
################################################################################################################################################################################################
