------------------------------------------------------------------------------------------------------------------------------------------------------------------------------------------------------------------------------------------------
------------------------------------------------------------------------------------------------------------------------------------------------------------------------------------------------------------------------------------------------
-----------------------------------------------------------------------------------------------------------------------------------------------------------------------------------------------------------------|------------------------------
-----------------------------------------------------------------------------------------------------------------------------------------------------------------------------------------------------------------|------------------------------
-----------------------------------------------------------------------------------------------------------------------------------------------------------------------------------------------------------------|------------------------------
-----------------------------------------------------------------------------*-------------------------------------------------------------------------------------------------------------------------##--------|------------------------------
------------------------------------------------------------M-----------------------------------------------------------------B-----------------------------------------oooo--------------------------###--------|------------------------------
-----------------------------------------------------------------------------------------------------------------------------------------------------------------------------------------------------####--------|------------------------------
----------------------------------------------------------------------------------------------------------------------------------------------------------------------------------------------------#####--------|------------------------------
-------------------------------------------------------ooo-------------------O---------------------------------------------------------------------------------------------------------------------######--------|------------------------------
------------------------------------------------------------#------------------------------------------------------------------------------------------------------------[]-----------------------#######--------|------------------------------
------------------------------------------------------------#--------------#---#----------------------------------------------#------------------------------------------pP----------------------########--------|------------------------------
-----------------k---------ggg------kkk-------kk-#----------#-----k-------ggg-k#------------K------------------k----------ggg-#-------k--------kkk-------kk----------kkk-------k------ggg------ggg#######--------|------------------------------
################################################################################--#########################################--###--##############################################################################################################
################################################################################--#########################################--###--##############################################################################################################
