----------------------------------------------------------------------------------------------------------------------------------------------------------------------------------------------------------------------------------------------------------------
----------------------------------------------------------------------------------------------------------------------------------------------------------------------------------------------------------------------------------------------------------------
------------------1223--------------------------------------------1223--------------------------------------------1223--------------------------------------------1223--------------------------------------------1223-----------|-----&&&----------------------
---1223-----------1223-----------------------------1223-----------1223-----------------------------1223-----------1223-----------------------------1223-----------1223-----------------------------1223-----------1223-----------|-----Q@Q---------1223---------
---1223--------------------------------------------1223------------------oo------------------------1223--------------------------------------------1223--------------------------------------------1223--------------------------|----&&&&&--------1223---------
------------------------------------oooo---------------o-o-o------------o--o---------------------ooo--M-----ooo----------------------oooooo----------------------------------------------------------------------------##--------|----@@N@@---------------------
--------------------------------------123---------------o-o---------------------------123---------------------------------------------123------------------------------------oooooo---123-----------------------------###--------|----@@N@@---------------------
---------123-----------------------123123----------------123-----------------------123123----------------123-----------------------123123----------------123-----------------------123123----------------123---------####--------|-123&&&&&--------------123----
-&&&-----123-----------------------123-------------------123-----------------------123--------------"""""123-----------------------123---------------oooo123-----------------------123-------------------123--------#####--------|-123@N@N@--------------123----
-Q@Q-----------""""""""""""""""-"""""""""""""""-""""""""""""""""-----""""""""""------""""""""""----#######----------------"""---"""""""""""""""-----------------""""""""---""--""--""---"""""""""------------------######--------|----@N@N@---------------------
&&&&&-------####################################################----############----############---#-----#----------------###--#################---------------##########--##--##--##--############---------------#######--------|----@@@@@---------------------
@@N@@------####-------------123#--------------1#3--------------#----#-------123#----#---------1#3--#-----#------------------123#--------------1#3--""""""""----#--------#---123--------#------123###-------------########---123--|----N@N@N---123---------------
@@N@@-----#####-------------123#--------------1#3--------------#----#-------123#----#---------1#3--#-----#------------------123#--------------1#3-##########---#--------#---123--------#------123####-----------#########---123--|----N@N@N---123---------------
######--########---------------#---------------#---------------#----#----------#----#----------#---#-----#------########-------#---------------#--#--------#---#--------#--------------#--------#############-##################################################
######---!!!!!!----------------#---------------#---------------#----#----------#----#----------#---#-----#-------!!!!!!--------#---------------#--#--------#---#--------#--------------#---------!!!!!!!!!!!--##################################################
