------------------------------------------------------------------------------------------------------------------------------------------------------------------------------------------------------------------------------------------------
------------------------------------------------------------------------------------------------------------------------------------------------------------------------------------------------------------------------------------------------
------------------------------------------------------------------------------------------------------------------------------------------------------------------------------------------------------------------------|-----------------------
------------------------------------------------------------------------------------------------------------------------------------------------------------------------------------------------------------------------|-----------------------
------------------------------------------------------------------------------------------------------------------------------------------------------------------------------------------------------------------------|-----------------------
------------------------##-----------------B+BBBBBBBBBBBBBBBBBBBBBBBBBBBBBBB----------------------------------------------------------------------------------------------------------------------------------##--------|-----------------------
-----------------------###------------------------------------------------------------------------------------------------------------------------------------------------------------------------------------##--------|-----------------------
----------------------####----------------------------------------------------------------------------------------------------------------------------------------------------------------g-------------------##--------|-----------------------
----------------------####----------------------------------------------------------------------------------------------------------------------------------------------------------------#----------------#--##--------|-----------------------
--------------------#-####---------------------------------------------------BB--------------------BB---------BB------B#O-----------------------------------[]--------------------------g##----------------#--##--------|-----------------------
-------------------##-####----------------------------------------------------------------------------------------------------------------------------------pP--------------------------###--------------#-#--##--------|-----------------------
------------------###-####------------------B--------------------------------------------------------------------------------------[]---------[]------------pP-----[]------------------####-------------##-#--##--------|-----------------------
#####------------####-####---------------------------------------------------------------------------------------------------------pP---------pP------------pP-----pP-----------------#####------------###-#--##--------|---#####---------------
###############-#####-##############-########-####-#-###-######-##############--####-#####################################################-#####-#-#------####################-#---#######################-#--##################################
