--------------------------------------------------------------------------------------------------------------------------------------------------------------------------------
--------------------------------------------------------------------------------------------------------------------------------------------------------------------------------
-------------------------------------------M--------------------------ooo--------------------------------------------------------------------------|----------------------------
---------------------------------------------------------o------------###--------------------------------------------------------------------------|----------------------------
--------------------ooo---------###-------------------------------------------k-------------------------o------------------------------------------|----------------------------
-------------------#####---------------#####------------------------------#####--------------------------------------------------------------------|----------------------------
-------------------------------------------------------------------ooo-----------------------------------------------###---------------------------|----------------------------
------------------------------------------------o------------------###--------------------------o--------------------------------------------------|----------------------------
------------------------ooookk---------------------###-------------------o---------------------------------------ooooo-----------------------------|----------------------------
-----------------------#######--------------###-------------------------###---------###--------------------------#####-----------------------------|----------------------------
---------------------------------------------------------------------------------------------------------###----------------------#####------------|----------------------------
--------------------------------------oko----------------------------------------------------------###---------------------------------------------|----------------------------
------------------------------------#######-------------------------k------------------------------------------------------------------------------|----------------------------
##############--#####--------------------------------------------#####---------------------------------------------------#######------------####################################
##############------------------------------------------------------------------------------------------------------------------------------####################################
