--------------------------------------------------------------------------------------------------------------------------------------------------------------------------------------------------------------------------------
--------------------------------------------------------------------------------------------------------------------------------------------------------------------------------------------------------------------------------
---------------------------123---------------123---------------------------123---------------123---------------------------123---------------123---------------------------123---------------123-------|-------------------123--
1223--------------123------1231223-----------1231223--------------123------1231223-----------1231223--------------123------1231223-----------1231223--------------123------1231223-----------1231223---|----------123------12312
1223--------------123---------1223--------------1223--------------123---------1223--------------1223--------------123---------1223--------------1223--------------123---------1223--------------1223---|----------123---------12
------------------------------------------------------------------------------------------B*B------------------------------------------------------------------------------------------------##--------|------------------------
---------------------------------------------------------------------------------------------------------------------------------------------------------------------------------------------##--------|------------------------
------------------------------------------------------------------------------------------------------------------------------------------------------------[]-------------------------------##--------|------------------------
-&&&--------------------------------------------------------------------------------------------------------------------------------------------------------pP------------------------J---#--##--------|----&&&-----------------
-Q@Q-------------------------------------------------------------------------------------#####-----------------------------------------------------#IBB-----##---------------------------##--##--------|----Q@Q-----------------
&&&&&--------T-------T---------------------T[]-----[]--------T-------T-------------------#-T-----------------T------#T---------------------T-------#---------T-------T------------------###T-##--------|---&&&&&-----T----------
@@N@@------f-T-------T-ff---------------f--TpP-----pP------f-T-------T-ff---------------f#-T---------------f-T-C----#T-ff---------------f--T-------#-------f-T-C---[]T-ff-C------------####T-----------|---@@N@@-----T-ff-------
@@N@@------!-!%%k%---!ggg--------ggg--%%!%-kpPk----pP------!-J%%%%--ggg!!------ggg----%J!#-!--------------ggg!%c%%--#!-!!---gggk------%%!%ggg------#kk-----!-!%c%%-pP!-!!-c-------J---#####!-----------|---@@N@@%%---!-!!-------
#################################################--#########################################----##################--####################################---#####################################################################
#################################################--#########################################----##################--####################################---#####################################################################
