--------------------------------------------------------------------------------------------------------------------------------------------------------------------------------------------------------------------------------
--------------------------------------------------------------------------------------------------------------------------------------------------------------------------------------------------------------------------------
--------------------------------------------------------------------------------------------------------------------------------------------------------------------------------------------------------|-----------------------
----------------------------------------------------------------------------------------------------------------------------------------------------------------------------------------------##--------|-----------------------
----------------------------------------------------------------------------------------------------------------------------------------------------------------------------------------------##--------|-----------------------
----------------------------+BBB-------------------------------------*BBB--------BBBBB------BBBB-----------------------------BBBB-----------------------------------BBBBB---B-------------?---##--------|-----------------------
------------------------g---------------------------------------------------------------------------------------------------------------------------------------------------------------------##--------|-----------------------
----------------------------------------------------------------------------------------------------------------------------------------------------------------------------------------------##--------|-----------------------
------------------------#------------------------------k-----------------------------------------------g--------------------------[]----------------------------------------------------------##--------|-----------------------
---------------BBB-----##---?-----#-----------[]-----M--------------B-----[]---------------------------[]-----------------[]------pP-----------------------------O--------?--------------BB---##--------|-----------------------
----------------------###---------#-----------pP--------------------------pP---------------------------pP-----------g-----pP--[]--pP----------------------#---------------------[]------------##--------|-----------------------
---------------------####---------##----------pP--------------------------pP---------------------------pP----------[]-----pP--pP--pP----------------------#---------------------pP----------B-##--------|-----------------------
#####---------------#####-------kk##---------ggP--------------gg--k----gggpP--------------ggg----------pP----------pP---g-pP--pP--pP-----k----------------#----------gg---------pP-------k----##--------|---#####---------------
############################################################################################----##########---##############################---##########--######################################################################
