------------------------------------------------------------------------------------------------
------------------------------------------------------------------------------------------------
#----###########################################################################################
#----############---------------------###-------------------------##############################
#----############---------------------###-------------------------##############################
#---------#######---------------------###-------------------------##############################
#------------------------------------------------------------------#############################
#----------------------------------------------------q-------------#d###########################
#------------------------------------------------------------------#D###########################
#---------#######-------------------------------------------------##############################
#----############---------------------###-------------------------##############################
#--[]############---------------------###----------q--------------##############################
#--pP############-----------q---------###-------------------------##############################
###pP###########################################################################################
################################################################################################
