--------------------------------------------------------------------------------------------------------------------------------------------------------------------------------
--------------------------------------------------------------------------------------------------------------------------------------------------------------------------------
--------------------------------------------------------------------------------------------------------------------------------------------------------------------------------
------------------------------------------------------------------------------------------------------------------------------------BB------------------------------------------
------------------------------------------------------------------------------------------------------------------------------------BB------------------------------------------
------------------------------------------------------#---------#---------------#---------------------------------------------------BB------------------------------------------
---------------------------------------------------------------------------------ooo--------------------------------------------------------------------------------------------
###-----------------------------------------------------------------------------------------------------------------------------------------------------------------------------
####----------------------------------------------------------------------------------------------------------------------------------------------------------------------------
#####-------------------------------------?M?-----------------------------------------------------------------------------------------------------------------------------------
--------------------------------------------------------------------------------------------------------------------------------------------------------------------------------
-------------------#----#----#------------------------#---------#---------------#-----------------------------------------------------------------------------------------------
-----------------------------------------------------###-------###-------------###----------------------------------------------------------------------------------------------
################--###--###--###--###############################################################################################################################################
################--###--###--###--###############################################################################################################################################
