------------------------------------------------------------------------------------------------------------------------------------------------------------------------------------------------
------------------------------------------------------------------------------------------------------------------------------------------------------------------------------------------------
----------------------------oo-------------------------------------------------------ooo-------------------------------------------------------------------------------|------------------------
-------------------------------------------------------M-----------------------------###------------------------------------------------------------------oo-----------|------------------------
-------------------------------------------ooooooo---------------------------------------------------------------------------------------------------------------------|------------------------
-------------------------------------------------------------------------oo-----------------------------------------------------oo--###---------------------###--------|------------------------
-----------------------------------------------------------------------------------------------------------------------------------------------------------------------|------------------------
-------------------------------------------------------------------------------------------------------------------------------------------------oo--------------------|------------------------
------------------------------------------------------------------------------------------###-------oooo---------------------------------------------------------------|------------------------
---------------------###-------####------------------------------#####-------------------------------------#####-----------------------####----------------------------|------------------------
-------------------------------------------------------------------------------------#####-----------------------------------------------------------------------------|------------------------
--------------------------------------Y----------####---------------------------------------------------------------Y--------------------------------------------------|------------------------
--------------------------------------y-----------------------------------------------------------------------------y--------------------------------------------------|------------------------
###############---###---###----------###---###-----------------------------------------------###-####--###-------#####-----###------####-----------------------#################################
###############------------------------------------------------------------------------------------------------------------------------------------------------#################################
