--------------------------------------------------------------------------------------------------------------------------------------------------------------------------------------------------------------------------------
--------------------------------------------------------------------------------------------------------------------------------------------------------------------------------------------------------------------------------
--------------------------------------------------------------------------------------------------------------------------------------------------------------------------------------------------------|-----------------------
--------------------------------------------------------------------------------------------------------------------------------------------------------------------------------------------------------|-----------------------
---------------------ooo--------------------------------------------------------------oo------------------------------------h--------------------------------r--------------oo--------------------------|-----------------------
-----------------------------BBBBBm--------------------------------------------------HBB------------------------------BBBBBBB*---------------------------BBBBB--------------BBBB--------------##--------|-----------------------
---------------------------------------------------------------------------------------------------------------------------------------------------------------------------------------------###--------|-----------------------
-----------------C---------------------------------------------------##----------h-----------------------------------------------------------------------------------------------------------###--------|-----------------------
-----------------c-----------ooo---------------------------------g--###------------------BBB----------------------------h-----------------------------------------------------------------J#-###--------|-----------------------
---------------####----------BBBBBB-----------h##----------------#--###-------?????-i---------------------------------BBBBBBBB---------------------BBB------------------m-----------------##-###--------|-----------------------
--------------##------------------------------###------[]------g##--###----------------------------------------------------------#--------------------------------------------------------##-###--------|-----------------------
-------------###---------Y-------------------#####-----pP------###--###------------------------------------C-------[]------------#-----------Om------------------------------[]---------#-##-###--------|-----------------------
------------####-------k-y--------------J---######------------####--###------------------oo---------------Jc---------------------#------ttt----------------gg------J--J----------------##-##-###--------|-----------------------
##########################---#####################################--########################----###############################--###############-------###################---##--########-##-###################################
##########################---#####################################--########################----###############################--###############-------###################---##--########-##-###################################
