----------------------------------------------------------------------------------------------------------------------------------------------------------------------------------------------------------------
----------------------------------------------------------------------------------------------------------------------------------------------------------------------------------------------------------------
-&&&-----------------------123---------------123---------------------------123---------------123---------------------------123---------------123-------m-------------------123-----|---------123----------------
1Q@Q--------------123------1231223-----------1231223--------------123------1231223-----------1231223--------------123------1231223-----------1231223--------------123----t-1231223-|---------1231223------------
&&&&&-------------123---------1223--------------1223--------------123---------1223--------------1223--------------123---------1223--------------1223--------------123---------1223-|------------1223------------
@@N@@----------------------mBB----------------------------------------------------BBBBBBB----I----------------------------------------BBBBB------------------------------##--------|----------------------------
@@N@@----------------------------------------------------------------------------------------------------------------------------------------------------BB-------------###--------|----------------------------
&&&&&&&&&&&&&&&&&&&&&&&&&&&&&&&&&&&&&&&&&&&&&&&&&&&&&&&&&&&&&&&&C&&&&&&&&&&&&&&&&&&&&&&&&&&&&&&&&&&&&&&&&&&&&&&&&&&&&&&&&&&&&&&&&&&&&&&&&&&&&&&&&&&&&&&&&&&&&&#&&&&&&&&####&&&&&&&&|&&&&&&&&&&&&&&&&&&&&&&&&&&&&
@N@N@@@@@@@@@@@@@@@@@@@@@@@@@@@@@@@@@@@@@@@@@@@@@@@@@@@@@@@@@@@@c@@@@@@@@@@@@@@@@@@@@@h@@@@@@@@@@@@@@@@@@@@@@@@@@@@@@@@@@@@@@@@@@@@@@@@@@h@@@@@@@@@@@BB@@@@@@##@@@@@@@#####@@@@@@@@|@@@@&&&@@@@@@@@@@@@@@@@@@@@@
@N@N@@@@@@@@@@@@@@@@@@@@@@@@@@@@@@@@@@@????@@@@@@@@@@@@@@@@@@@BB#OB@@@@@@@@@@@@@@@BBBBBBB@@@@@@@@@@@@@@@@@@@@@@@@@@@@@@@@@@@@@@@@@@@@@BBBBB@@@@@@@@@@@@@@@@@###@@@@@@######@@@@@@@@|@@@@Q@Q@@@@@@@@@@@@@@@@@@@@@
@@@@@@@@@@@@@@@@@@@@@@@@@@@@C@@@@@@@@@@@@@@@@@C@@@@@@@@@C@@@@@@@@@@@@@@@@--@[]@@@@@@@@@@@@@@@[]@@@@@@@@@@@@@@[]@@@@@@@@@@@@@@@@@@@@@@@@@@@@@@#@@@@C@@@@@-@@####@@@@@#######@@@@@@@@|@@@&&&&&@@@@@@@@@@@@@@@@@@@@
N@N@N@@@@@@@@@@@@@@C@@@@@@@@c@@@@@@@C@@@@@@@@@c@@@@@@@@@c@@@@@@@@@@@C@@@@--@pP@@@@@@@@@@@@@@@pP@@@@@@@@@C@@@@pP@@@@[]@@@@@C@@@@@[]@@@@@@@@@@@#@@@@c@@@@Y-@#####@@@@########@@@@@@@@|@@@@@N@@@@@@@@@@@@@@@@@@@@@@
N@N@N@@@@@@@@@@@@@@c@@@@@@J@C@@@@@@@c@@@@@@@J@c@@@@@@J@@C@@@@@@@@J@@c@@@@--@@@@@@@@@h@@@@@@@@@@@@@@@@@@@c@@@@@@@@@k@@@@@@@c@@@@@@@@@@@@h@@@@@#@@@@C@@@@y-######@@@#########@@@@@@@@|@@@@@N@@@@@@@@@@@@@@@@@@@@@@
#########################################################################--#############################################################################-#######################################################
#########################################################################--#############################################################################-#######################################################
