--------------------------------------------------------------------------------------------------------------------------------------------------------------------------------------------------------------------------------
--------------------------------------------------------------------------------------------------------------------------------------------------------------------------------------------------------------------------------
-----------------------------------------------------------------------------------------+--------------------------------------------------------------------------------------------------------------------------------------
--------------------------------------------------------------------------------------------------------------------------------------------------------------------------------------------------------------------------------
---------------------------------------------------------g----------------------------------------------------------------------------------------------------------------------------------------------------------------------
-----------------------------------------oooo----------------------B----BB----------oooooo--------------------------------------------------------------------------------------------------------------------------------------
-------------------------------------------------------------------B----BB------------------------------------------------------------------------------------------------------------------------------------------------------
---------------------------------------B-BBBB-*--------------------B----BB----------BBBBBB--------------------------------------------------------------------------------------------------------------------------------------
-----------------------------O---------BoB--BoB-----------oooo-gg--BoB--BO----------BBBBBB-------------------------------------------------------BBBBBB---gg--------------------------------------------------------------------
----------M------------#-#-------------BBB--BBB-------BB--BBBB-----BBB--BB--BBBB-----------------------------[]-------------------------##--------------------------------------------------------------------------------------
---------------------#-#-#-#---#----------------------BB-----------------------------------------------[]----pP-----------BB-----------###----------------------B-----------------[]--[]--[]------------------------------------
-----------------g-#-#-#-#-#---#-#--------------------BB-----------------------------------------------pP----pP----[]-----BB----------####----------------------B-----------------pP--pP--pP------------------------------------
----------------g#-#-#-#-#-#-g-kk#---------k--g-g------------------------------------------------------pP----pP----pP-ggg-BB-----g---#####----------------------B-----------------pP--pP--pP------------------------------------
################################################################################---#####################################--##--##################################################################################################
