--------------------------------------------------------------------------------------------------------------------------------------------------------------------------------
--------------------------------------------------------------------------------------------------------------------------------------------------------------------------------
################################################################################################################################################################################
########################-------------###################################--------#-------#--------#######-------------------#####--------------##--------------------------------
########################-------------###################################--------#-------#--------#######-------------------#####--------------##--------------------------------
-----------------------#-------------###################################-----------------------------------i--i--i----------------------------##--------------------------------
-----------------------#------M------#-----------#----------#------#------------------------------------------------------------------------------------------------------------
###-----------------------------------------------------------------------------------------------------------------------------------------------------------------------------
####----------------------------------------------------------------------------------------------------------------------------------------------------------------------------
#####------------------------------#####################################----#-------#-------#-------------i--i--i----------------------W-----###--------------------------------
#############--###########---###---#####################################################################------------####---#####=============###--------------------------------
#############--###########---###---#####################################################################------------####---#####-------------###--------------------------------
#############^^###########---###---#####################################################################------------####---#####-------------###--------------------------------
#############::###########^^^###^^^#############################################################################################^^^^^^^^^^^^^###################################
#############::###########:::###:::#############################################################################################:::::::::::::###################################
