------------------------------------------------------------------------------------------------
------------------------------------------------------------------------------------------------
------------------1223----------------------------------------##--1223--------------------------
---1223-----------1223--------ooooo----------------1223-------##--1223--------------------------
---1223---------ooo---ooo-----#####-------------############--##--------------------------------
----------------###---###-------j--------------##-------------##--------------------------------
-----------------j-----j--ooo---j-----123-----###-------------##----------------------123-------
---------123-----j-----j--###---j--123123----####--------123--##-------------------123123-------
---------123ooo--j-----j---j----j--123------#####--------123--##-------------------123----------
------------###--j-----j---j----j--oo------######-------------##--------------------------------
-------------j---j-----j---j---#######----#######-[]--[]--[]--##--------------------------------
3------------j---j###-#####j123-j-j------########-pP--pP--pP--##------------123---------------12
3------------j---j-j---jj--j123-j-j-----#########-------------##------------123---------------12
####-###########################################################################################
####-###########################################################################################
