--------------------------------------------------------------------------------------------------------------------------------------------------------------------------------------------------------------------------------
--------------------------------------------------------------------------------------------------------------------------------------------------------------------------------------------------------------------------------
--------------------------------------------------------------------------------------------------------------------------------------------------------------------------------------------------------|-----------------------
--------------------------------------------------------------------------------------------------------------------------------------------------------------------------------------------------------|-----------------------
---------------------ooo--------------------------------------------------------------oo------------------------------------------------------------------------------------oo--------------------------|-----------------------
-----------------------------BBBBBB--------------------------------------------------BBB------------------------------BBBBBBB*---------------------------BBBBB--------------BBBB--------------##--------|-----------------------
---------------------------------------------------------------------------------------------------------------------------------------------------------------------------------------------###--------|-----------------------
---------------------------------------------------------------------##----------------------------------------------------------------------------------------------------------------------###--------|-----------------------
-----------------------------ooo---------------------------------g--###------------------BBB-----------------------------------------------------------------------------------------------#-###--------|-----------------------
---------------####----------BBBBBB------------##----------------#--###-------------?---------------------------------BBBBBBBB---------------------BBB------------------B-----------------##-###--------|-----------------------
--------------##------------------------------###------[]------g##--###----------------------------------------------------------#--------------------------------------------------------##-###--------|-----------------------
-------------###---------B-------------------#####-----pP------###--###--------------------------------------------[]------------#-----------OB------------------------------[]---------#-##-###--------|-----------------------
#####-------####-------k--------------------######-----pP-----####--###------------------oo------------------------pP------------#-------------------------gg----------------pP--------##-##-###--------|---#####---------------
##########################---#####################################--########################----###############################--###############-------###################---##--########-##-###################################
##########################---#####################################--########################----###############################--###############-------###################---##--########-##-###################################
