----------------------------------------------------------------------------------------------------------------------------------------------------------------------------------------------------------------------------------------------------------------
----------------------------------------------------------------------------------------------------------------------------------------------------------------------------------------------------------------------------------------------------------------
---------------------------------------------------------------------------------------------------------------------------------------------------------------------------------------------------------------------------------|------------------------------
---------------------------------------------------------------------------------------------------------------------------------------------------------------------------------------------------------------------------------|------------------------------
------------------------------------------------------------------------------------------------------------------------------------------------------------------------------------------------------------------------#--------|------------------------------
-------------------------?--------------------------------------?-?-------------------------+--------------------------------------------------------------------------------------------------------------------------##--------|------------------------------
---------------------------------------------------------------------------------------------------------oooo----------oooo------------oooo---------------------------------------------------------------------------###--------|------------------------------
---------------------------------------------------------------------------------------------------------------------------------------------------------------------------------------------------------------------####--------|------------------------------
------------------------------------------oo------------------------------------------------------------------------------------------------------------------------------------------------------------------------#####--------|------------------------------
-------------------------M---------------o--o-------------------?-?-------------------------------------------------[]--------------[]--------------MBB------------------------------------------------------------######---O----|------------------------------
---------------------[]--------------------------------------------------------------------------------#------------pP--------------pP-------------------------------------------------------#--------------------#######--------|------------------------------
---------------------pP--------------------------------------------------------------------------------#------------pP--------------pP-----------------------------[]------------------------#-------------------########--------|------------------------------
#####----------------pP--------------------------------------------------------------------------------#------------pP--------------pP-----------------------------pP------------------------#------------------#########--------|---#####----------------------
################################--############################################----###################################################################--#######################---###--########--################################################################
################################--############################################----###################################################################--#######################---###--########--################################################################
