------------------------------------------------------------------------------------------------------------------------------------------------------------------------------------------------
------------------------------------------------------------------------------------------------------------------------------------------------------------------------------------------------
------------------1223------oo------------------------------------1223-"""""---""""--ooo--------------------------1223---------""""------------------------------------|-----&&&----------------
---1223-----------1223-----------------------------1223M----------1223---------------###-----------1223-----------1223-----------------------------1223---oo-----------|-----Q@Q----------------
---1223------------------------------------ooooooo-1223-------------------------------!------------1223--------------------------------------------1223----------------|----&&&&&---------------
-------------------------------------------------------------------------oo-----------!-----------------------------------------oo--###---------------------###--------|----@@N@@---------------
--------------------------------------123---------------------------------------------123--------------------------------------------!123--------------------!---------|----@@N@@---------------
---------123-----------------------123123----------------123-----------------------123123----------------123-----------------------123123--------oo------123-!---------|----&&&&&---------------
-&&&-----123-----------------------123-------------------123-----------------------123!---###-------oooo-123-----------------------123-------------------123-!---------|----@N@N@---------------
-Q@Q-----------------###-------####------------------------------#####----------------!----!---------------#####---------------------!-####------------------!---------|----@N@N@---------------
&&&&&-----------------!---------!!--------------------------------!!!----------------#####-!----------------!!!----------------------!--!!-------------------!---------|----@@@@@---------------
@@N@@-----------------!-----123-!!----Y-------123####-------------!!!-------123-------!!!--!--123-----------!!!-----Y-------123------!--!!----123------------!---------|----N@N@N---------------
@@N@@-----------------!-----123-!!----y-------123-!!--------------!!!-------123-------!!!--!--123-----------!!!-----y-------123------!--!!----123------------!---------|----N@N@N---------------
###############---###-!-###-----!!---###---###----!!--------------!!!-----------------!!!--!-###-####--###--!!!--#####-----###------####!!-------------------!-#################################
###############----!--!--!------!!----!-----!-----!!--------------!!!-----------------!!!--!--!---!!----!---!!!---!!!-------!--------!!-!!-------------------!-#################################
