----------------------------------------------------------------------------------------------------------------------------------------------------------------------------------------------------------------------------------------------------------------
----------------------------------------------------------------------------------------------------------------------------------------------------------------------------------------------------------------------------------------------------------------
---------------------------------------------------------------------------------------------------------------------------------------------------------------------------------------------------------------------------------|------------------------------
---------------------------------------------------------------------------------------------------------------------------------------------------------------------------------------------------------------------------------|------------------------------
-------------------------------------------------------------------------oo---------------------------------------------------------------------------------------------------------------------------------------------#--------|------------------------------
------------------------------------oooo---------------o-o-o------------o--o---------------------ooo--M-----ooo----------------------oooooo----------------------------------------------------------------------------##--------|------------------------------
--------------------------------------------------------o-o------------------------------------------------------------------------------------------------------------------oooooo-----------------------------------###--------|------------------------------
---------------------------------------------------------------------------------------------------------------------------------------------------------------------------------------------------------------------####--------|------------------------------
-----------------------------------------------------------------------------------------------------------------------------------------------------oooo-----------------------------------------------------------#####--------|------------------------------
---------------------------------------k-----------------------------------------------------------#-----#---------------------------------------------------------------------------------------------------------######--------|------------------------------
------------###----------------#---------------#---------------#----#----------#----#----------#---#-----#---------------------#---------------#---------------#--------#--------------#---------##---------------#######--------|------------------------------
-----------####----------------#---------------#---------------#----#----------#----#----------#---#-----#---------------------#---------------#---------------#--------#--------------#---------###-------------########--------|------------------------------
#####-----#####----------------#---------------#---------------#----#----------#----#----------#---#-----#---------------------#---------------#--#--------#---#--------#--------------#---------####-----------#########--------|----#####---------------------
################################################################################################################################################################################################################################################################
################################################################################################################################################################################################################################################################
