------------------------------------------------------------------------------------------------------------------------------------------------------------------------------------------------------------------------------------------------------------------------------------------------------------------------------------------------
------------------------------------------------------------------------------------------------------------------------------------------------------------------------------------------------------------------------------------------------------------------------------------------------------------------------------------------------
################################################################################################################################################################################################################################################################################################################################################
-----------------------------------------------------------------------------------------------------------------------------------------------------------------------------------------------------------------------------------------------------------------------------------------######--------------##---------------------------------
-----------------------------------------------------------------------------------------------------------------------------------------------------------------------------------------------------------------------------------------------------------------------------------------######--------------##---------------------------------
-------------------------------------------------------------------------------------------------------------------------------------------------------------------------------------------------------------------------------------------------------------------------------------------------------------##---------------------------------
----------------------------------------------------------------------------####------------------------------------------------------------------------[]--------------------------------------------------------------------------------------------------------------------------------------------------------------------------------------
###---------------------------------------------------------------------------------------[]------------------------------------------------------------pP----------------------------------------------------------[]--------------------------------------------------------------------------------------------------------------------------
####-----------------------------------------------------------------------------[]-------pP------------------------------------------------------------pP--------------------------------------------------[]------pP--------------[]----------------------------------------------------------------------------------------------------------
#####----------------------------------------------------------------------------pP-------pP----------------------------------------------------------i-##--------------------------------------------------pP------pP--------------pP-----------------------------------------------------------------W----###---------------------------------
#####--------------------------------------------------------####---------#######pP#######pP###---------------------------[]------------------[]-----------------------------------------------------#######pP######pP#####----#####pP#########################--------------------------######-=============##---------------------------------
#####--------------[]------------------------------[]-------g####---------#######pP#######pP###--------------------[]-----pP--------[]--------pP---------------------------------------------------[]#######pP######pP#####----#####pP#########################----[]-----[]-------------######-------------###---------------------------------
#####--------------pP------------------------------pP------gg####---------#######pP#######pP###--------------------pP-----pP----t-t-pP-----J-JpP-----------J-J-------------------------------------pP#######pP######pP#####----#####pP#########################----pP-----pP-----h-------######-------------###---------------------------------
#####^^^^^#########pP##############################pP############^^^^^^^^^#######pP#######pP#######################pP#####pP########pP########pP^^#################################################pP#######pP######pP#####^^^^#####pP#############################pP#####pP########^^^^^######^^^^^^^^^^^^^####################################
#####:::::#########pP##############################pP############:::::::::#######pP#######pP#######################pP#####pP########pP########pP::#################################################pP#######pP######pP#####::::#####pP#############################pP#####pP########:::::######:::::::::::::####################################
