----------------------------------------------------------------------------------------------------------------------------------------------------------------------------------------------------------------------------------------------------------------
----------------------------------------------------------------------------------------------------------------------------------------------------------------------------------------------------------------------------------------------------------------
#-----###################################################----------#############################################-------####-----###########################-----#############################pP############################---##################################
#-------------------B###########################----------------------------------------------------------------------------------------------------------------################-------------pP##################-------------##################################
#-------------------B######################O####----------------------------------------------------------------------------------------------------------------################-------------pP##################-------------##################################
#-------------------B###########################--??------------HBB----------------------------------------------------BmB--------------------------------------################-------------pP##################-------------##################################
#-----------------------------------------------------------------------------[]--------------------------------------------------------------------------------B-------------------[]-------pP##################-------------##################################
#---------------------------------------------------------------i-------------pP--------------------------------------------------------------------------------B-------------------pP-------pP##################-------------##################################
#---------------------------------------------ggg--------------i-i------------pP-------B--------------------------------------------------------------------------oooooooooo--------pP-----{}(P##################-------------##################################
#---------------------BBBBBBm-##################--??--?M?---------i---------BOpPB*-------------------------[]----------BBBB-------------------[]----------t------mBBBBBBBBBB----#---pP-----dD)P##################-------------##################################
#---------------------BBBBB---##################------------------------[]----pP----[]---[]-------------#--pP--##-------------------------[]--pP----------#--------------------##---pP---########################-----[]------##################################
#---------------------BBBBB---##################------------------------pP----pP----pP---pP------------##--pP--##------------------[]-----pP--pP---------##-------------------###---pP---########################-----pP------##################################
#--------------------------ooo##################------------------------pP---kpP---tpP--tpP-----------k##k-pP--##------------------pP----kpP--pP--------###----------------kk####--tpP---########################-----pP------##################################
###########--##--#---####################################------##########################################--##--##------####------###############--#########-----#######################--#######################################################################
###########--##--#---####################################------##########################################--##--##------####------###############--#########-----#######################--#######################################################################
