--------------------------------------------------------------------------------------------------------------------------------------------------------------------------------------------------------------------------------
--------------------------------------------------------------------------------------------------------------------------------------------------------------------------------------------------------------------------------
-------------------------------------------------------------------------------------------------------------------------------------------------------------------------------------------------------|------------------------
-------------------------------------------------------------------------------------------------------------------------------------------------------------------------------------------------------|------------------------
-------------------------------------------------------------------------------------------------------------------------------------------------------------------------------------------------------|------------------------
------------------------------------------------------------------------------------------B*B------------------------------------------------------------------------------------------------##--------|------------------------
---------------------------------------------------------------------------------------------------------------------------------------------------------------------------------------------##--------|------------------------
------------------------------------------------------------------------------------------------------------------------------------------------------------[]-------------------------------##--------|------------------------
--------------------------------------------------------------------------------------------------------------------------------------------------------------------------------------J---#--##--------|------------------------
-----------------------------------------------------------------------------------------#####-----------------------------------------------------#IBB-----##---------------------------##--##--------|------------------------
--------------------------------------------[]-----[]------------------------------------#--------------------------#------------------------------#------------------------------------###--##--------|------------------------
--------------------------------------------pP-----pP------------------------------------#---------------------C----#------------------------------#-----------C---[]-----C------------####------------|------------------------
----------------k-----ggg--------ggg--------kk---------------J------ggg--------ggg-----J-#----------------ggg--c----#-------gggk----------ggg------kk----------c----------c-------J---#####------------|------------------------
#################################################--#########################################----##################--####################################---#####################################################################
#################################################--#########################################----##################--####################################---#####################################################################
