----------------------------------------------------------------------------------------------------------------------------------------------------------------------------------------------------------------
----------------------------------------------------------------------------------------------------------------------------------------------------------------------------------------------------------------
------------------------------------------------------------------------------------------------------------------------------------------------------------------------------------------|---------------------
------------------------------------------------------------------------------------------------------------------------------------------------------------------------------------------|---------------------
------------------------------------------------------------------------------------------------------------------------------------------------------------------------------------------|---------------------
------------------------------------BB---------------------------------------------------------------------------?--------------------------------------------------------------##--------|---------------------
-----------------------------------------------------------------------------------------#BBB-----------------------------------------------------------------------------------##--------|---------------------
----------------------------------------------------------------------------oo----------##----------------------------------------------------------#BB-------------------------##--------|---------------------
---------------------------------------------------------------------------------------###+--------------ooo------------------#BB-M?---------------##------------------------#--##--------|---------------------
-----------------------------------###---BBO------------------ooo-------##-------------###-----------------------?-----------##-------------------###--BO-------------------##--##--------|---------------------
--------------------------------####-----------------------------------###-----------#-###--BBB-------[]--------------------###------------------####----------------------###--##--------|---------------------
-----------------------------#####------------------------------------####----------##-###------------pP-------------------####-----------------#####---BBB---------------####--##--------|---------------------
#####---------------------######-------------------------------------#####-------------###------------pP------------------#####---BBBBB--------######--------------------#####--##--------|-----#####-----------
####################--#################--################--###############---################---###############################-------##-###########################---#######--################################
####################--#################--################--###############---################---###############################-------##-###########################---#######--################################
