----------------------------------------------------------------------------------------------------------------------------------------------------------------------------------------------------------------
----------------------------------------------------------------------------------------------------------------------------------------------------------------------------------------------------------------
-------------------------------------------------------------------------------------------------------------------------------------------------------B---------------------------|----------------------------
-----------------------------------------------------------------------------------------------------------------------------------------------------------------------------------|----------------------------
--------------------------------------------------------------------------------------------------------------------------------------------------------------------------#--------|----------------------------
---------------------------BBB----------------------------------------------------BBBBBBB----+----------------------------------------BBBBB------------------------------##--------|----------------------------
---------------------------------------------------------------------------------------------------------------------------------------------------------BB-------------###--------|----------------------------
--------------------------------------------------------------------------------------------------------------------------------------------------------------#--------####--------|----------------------------
-----------------------------------------------------------------------------------------------------------------------------------------------------BB------##-------#####--------|----------------------------
--------------------------------------------------------------BB#OB---------------BBBBBBB---------------------------------------------BBBBB-----------------###------######--------|----------------------------
----------------------------------------------------------------------------[]---------------[]--------------[]------------------------------#-------------####-----#######--------|----------------------------
----------------------------------------------------------------------------pP---------------pP--------------pP----[]-----------[]-----------#---------B--#####----########--------|----------------------------
#####-----------------------------------------------------------------------pP---------------pP--------------pP---kpP-----------pP-----------#-----------######---#########--------|---#####--------------------
#########################################################################--#############################################################################-#######################################################
#########################################################################--#############################################################################-#######################################################
