----------------------------------------------------------------------------------------------------------------------------------------------------------------------------------------------------------------
----------------------------------------------------------------------------------------------------------------------------------------------------------------------------------------------------------------
-------------------------------------------------------------------------------------------------------------------------------------------------------m---------------------------|----------------------------
-------------------------------------------------------------------------------------------------------------------------------------------------------------------------t---------|----------------------------
-----------------------------------------------------------------------------------------------------------------------------------------------------------------------------------|----------------------------
---------------------------mBB----------------------------------------------------BBBBBBB----I----------------------------------------BBBBB------------------------------##--------|----------------------------
---------------------------------------------------------------------------------------------------------------------------------------------------------BB-------------###--------|----------------------------
----------------------------------------------------------------C---------------------------------------------------------------------------------------------#--------####--------|----------------------------
----------------------------------------------------------------c---------------------h--------------------------------------------------h-----------BB------##-------#####--------|----------------------------
---------------------------------------????-------------------BB#OB---------------BBBBBBB---------------------------------------------BBBBB-----------------###------######--------|----------------------------
----------------------------C-----------------C---------C-------------------[]---------------[]--------------[]------------------------------#----C--------####-----#######--------|----------------------------
-------------------C--------c-------C---------c---------c-----------C-------pP---------------pP---------C----pP----[]-----C-----[]-----------#----c----Y--#####----########--------|----------------------------
-------------------c------K-C-------c-------K-c------K--C--------K--c---------------h-------------------c---------k-------c------------h-----#----C----y-######---#########--------|----------------------------
#########################################################################--#############################################################################-#######################################################
#########################################################################--#############################################################################-#######################################################
