------------------------------------------------------------------------------------------------
------------------------------------------------------------------------------------------------
--------------------------------------------------------------##--------------------------------
------------------------------ooooo---------------------------##--------------------------------
----------------ooo---ooo-----------------------############--##--------------------------------
-----------------------------------------------##-------------##--------------------------------
--------------------------ooo-----------------###-------------##--------------------------------
---------------------------------------------####-------------##--------------------------------
------------ooo-----------------------------#####-------------##--------------------------------
-----------------------------------oo------######-------------##--------------------------------
------------------------------------------#######-[]--[]--[]--##--------------------------------
-----------------------------------------########-pP--pP--pP--##--------------------------------
----------------------------------------#########-pP--pP--pP--##--------------------------------
####-###########################################################################################
####-###########################################################################################
