------------------------------------------------------------------------------------------------------------------------------------------------------------------------------------------------------------------------------------------------
------------------------------------------------------------------------------------------------------------------------------------------------------------------------------------------------------------------------------------------------
------------------------------------------------------------------------------------------------------------------------------------------------------------------------------------------------------------------------|-----------------------
------------------------------------------------------------------------------------------------------------------------------------------------------------------------------------------------------------------------|-----------------------
---------------------------------------------------gg-------------------------------------------------------------------t-------------------------------------------------------------------------------------J---------|-----------------------
-----------------------BOB-----------------------------------------BBBBB-----BBBBH---------------------------------B---BBBBBBBBB------------*B---BB-------------BBB-------------------------------------------##--------|-----------------------
--------------------------------[]-----------------------------------------------------------------------------[]------------------------------------------------------[]------------------------------------###--------|-----------------------
--------------------------------------------------------------[]-----------------------[]----------------------pP------------------------------------------------------pP-----------------------------------####--------|-----------------------
--------------------------------##----------------------[]-----------------------------pP-------------------------------------------------BB---------------------------------------------------------------#####--------|-----------------------
----------BBB------[]---i---[]----------------[]---Bm---pP----##------------------i----pP-------------[]------B##B------------------------------BBB---------#---BBB----##-----[]-------[]----------------[]#####--------|-----------------------
-------------------pP-------pP----------------pP--------pP----------------------[]-----pP-----[]------pP-----------------------------------------------#-[]-#-----------------pP-----[]pP----[]----------pP#####--------|-----------------------
-------------------pP-------pP-----[][]-------pP--------pP---------[]-----[]----pP--[]-pP-----pP------pP-[]--------[]--------------[]--[]-------------##-pP-##----------------pP---[]pPpP----pP---------#pP#####--------|-----------------------
----------k----------------J----------t---------------------t----------------------------------------------------------------------------------------###----##-----t--------gg-------------------------##--#####--------|-----------------------
###########################################################################################################################------############-#-########-#######################################################################################
###########################################################################################################################------############-#-########-#######################################################################################
