--------------------------------------------------------------------------------------------------------------------------------------------------------------------------------
--------------------------------------------------------------------------------------------------------------------------------------------------------------------------------
################################################################################################################################################################################
################-------------------###########-------###-------###-------------###--------######---------------#################----BB--------##--------------------------------
################-------------------###########-------###-------###-------------###--------######---------------#################----BB--------##--------------------------------
------------------------------------------------------#---------#---------------#---------------------------------------------------BB--------##--------------------------------
---------------------------------------------------------------------------------ooo--------------------------------------------------------------------------------------------
###-----------------------------------------------------------------------------------------------------------------------------------------------------------------------------
####----------------------------------------------------------------------------------------------------------------------------------------------------------------------------
#####-------------------------------------?M?------------------------------------------------------------------------------------------w-----###--------------------------------
################--###--###--###--##-------------------------------------------------------######---###---###---#####--##########=============###--------------------------------
################--###--###--###--##-------------------#---------#---------------#---------######---###---###---#####--##########-------------###--------------------------------
################--###--###--###--##------------------###-------###-------------###--------######---###---###---#####--##########-------------###--------------------------------
################--###--###--###--#############^^########################################^^######^^^###^^^###^^^#################^^^^^^^^^^^^^###################################
################--###--###--###--#############::########################################::######:::###:::###:::#################:::::::::::::###################################
