--------------------------------------------------------------------------------------------------------------------------------------------------------------------------------------------------------------------------------
--------------------------------------------------------------------------------------------------------------------------------------------------------------------------------------------------------------------------------
--------------------------------------------------------------------------------------------------------------------------------------------------------------------------------------------------------|-----------------------
----------------------------------------------------------------------------------------------------------------------------------------------------------------------------------------------##--------|-----------------------
----------------------------------------------------------------------------------------------------------------------------------------------------------------------------------------------##--------|-----------------------
----------------------------IBBB---------------------?????-----------*BBB--------BBHBB------BBBB-----------------------------mBBB-----------------------------------BBBBB---m-------------i---##--------|-----------------------
------------------------g---------------------------------------------------------------------------------------------------------------------------------------------------------------------##--------|-----------------------
----------------------------------------------------------------------------------------------------------------------------------------------------------------------------------------------##--------|-----------------------
------------------------#------------------------------k-----------------------------------------------g--------------------------[]----------------------------------------------------------##--------|-----------------------
---------------BmB-----##---i-----#-----------[]-----M????----------B-----[]---????--???---------------[]-----------------[]------pP-----------------------------O--------?--------------BB---##--------|-----------------------
----------------------###---------#-----------pP--------------------------pP---------------------------pP-----------g-----pP--[]--pP----------------------#---------------------[]------------##--------|-----------------------
---------------------####---------##----------pP--------------------------pP---------------------------pP----------[]-----pP--pP--pP----------------------#---------------------pP----------Y-##--------|-----------------------
--------------------#####-------kk##---------gg---------------gg--k----ggg----------------ggg---------------------------g----------------k-------------J--#----------gg--J-J-------------k--y-##--------|-----------------------
############################################################################################----##########---##############################---##########--######################################################################
############################################################################################----##########---##############################---##########--######################################################################
