--------------------------------------------------------------------------------------------------------------------------------------------------------------------------------
--------------------------------------------------------------------------------------------------------------------------------------------------------------------------------
------------------1223---------------------M-----""""""""---------1223ooo--------"""""""""--""""""-----"""""""----1223-----------------------------|-----&&&--------------------
---1223-----------1223--------------R--------------1223--o--------1223###--------------------------1223-----------1223-----------------------------|-----Q@Q--------------------
---1223-------------ooo---------###----------------1223----------------j------r--------------------1223-o------------------------------------------|----&&&&&-------------------
-------------------#####---------j-----#####---------------------------j--#####--------------------------------------------------------------------|----@@N@@-------------------
---------------------j-----------j----123j-------------------------ooo-j----j---------123----------------------------###--------------123----------|----@@N@@-------------------
---------123---------j-----------j-123123j------o--------123-------###-j----j------123123-------o--------123----------j------------123123----------|----&&&&&-------------------
-&&&-----123---------j--oooorr---j-123---j---------###---123--------j--j-o--j------123-------------------123-----oooooj------------123-------------|----@N@N@-------------------
-Q@Q-----------------j-#######---j-------j--###-----j---------------j--j###-j-------###--------------------------#####j----------------------------|----@N@N@-------------------
&&&&&----------------j----j------j-------j---j------j---------------j--j-j--j--------j-------------------###-------j--j-----------#####------------|----@@@@@-------------------
@@N@@----------------j----j-123--j----oroj---j123---j---------------j--j-j--123------j--------123--###----j--------j--j-----123-----j--------------|----N@N@N-------------------
@@N@@----------------j----j-123--j--#######--j123---j---------------r--j-j--123------j--------123---j-----j--------j--j-----123-----j--------------|----N@N@N-------------------
##############--#####j----j------j-----j-j---j------j------------#####-j-j--j--------j--------------j-----j--------j--j--#######----j-------####################################
##############----j--j----j------j-----j-j---j------j--------------jj--j-j--j--------j--------------j-----j--------j--j-----j-------j-------####################################
