--------------------------------------------------------------------------------------------------------------------------------------------------------------------------------------------------------------------------------
--------------------------------------------------------------------------------------------------------------------------------------------------------------------------------------------------------------------------------
--------------------------------------------------------------------------------------------------------------------------------------------------------------------------------------------------------|-----------------------
--------------------------------------------------------------------------------------------------------------------------------------------------------------------------------------------------------|-----------------------
--------------------------------------------------------------------------------------------------------------------------------------------------------k--------------------------------------k--------|-----------------------
----------------------------------------------------------------------------------I-------*BB------------------BB?BBBMBBB--------BBH------------------B?B--B?B--------------------------------##--------|-----------------------
--------------------------------------------------------------------------------------------------------------------------------------------------------------------------------------------k###--------|-----------------------
--------------------------------------------------------------------------------------------------------------------------------------------g#----------------------------k----#------------####--------|-----------------------
-------------------?--M--------------------------------------------------------------ggg-------------------------h---------------BBB-------g##---------------------------------#-----------#####--------|-----------------------
----------------?---------BBB---------[]---------------------B--------------##########--#--------------[]------BBBBBBBBBBB-----------------###--------B?B--BMB--------BOBBB----#----------######--------|-----------------------
--------------------------------[]----pP-----------------[]----------------##--------#--#--------------pP---------------------------------####--------------------------------##---------#######--------|-----------------------
----------------------------J---pP----pP-----------------pP--------[]-----###--------#--##-------------pP---------------------Y----------#####--------------------------J-----##--------########--------|-----------------------
-------------------------J-----------g------------------ggg------k-------####--------#--##-------gg--k--------------h---------y---------######-------k-------ggg-----J-----J--##-------#########--------|-----------------------
#############################################---#############################--------#--########################################----##########--#################################---############################################
#############################################---#############################--------#--########################################----##########--#################################---############################################
