------------------------------------------------------------------------------------------------
------------------------------------------------------------------------------------------------
~~----~~~~~~~~~~~~~~~~~~~~~~~~~~~~~~~~~~~~~~~~~~~~~~~~~~~~~~~~~~~~~~~~~~~~~~~~~~~~~~~~~~~~~~~~~~
~~----~~~~~~~~~~~~---------------------~~~-------------------------~~~~~~~~~~~~~~~~~~~~~~~~~~~~~
~~----~~~~~~~~~~~~---------------------~~~-------------------------~~~~~~~~~~~~~~~~~~~~~~~~~~~~~
~~---------~~~~~~~---------------------~~~-------------------------~~~~~~~~~~~~~~~~~~~~~~~~~~~~~
~~------------------------------------------------------------------~~~~~~~~~~~~~~~~~~~~~~~~~~~~
~~---------------------------------------------------q--------------{~~~~~~~~~~~~~~~~~~~~~~~~~~~
~~------------------------------------------------------------------d~~~~~~~~~~~~~~~~~~~~~~~~~~~
~~---------~~~~~~~-------------------------------------------------~~~~~~~~~~~~~~~~~~~~~~~~~~~~~
##----############---------------------###-------------------------#############################
##-[]-############---------------------###---------q---------------#############################
##-pP-############----------q----------###-------------------------#############################
###pP###########################################################################################
###pP###########################################################################################
