--------------------------------------------------------------------------------------------------------------------------------------------------------------------------------
--------------------------------------------------------------------------------------------------------------------------------------------------------------------------------
-------------------------------------oo-----------------------------------------------------------------------------------------------------------------|-----------------------
--------------------------------------------g-g---------------------------------------------------------------------------------------------------------|-----------------------
---------------------------ooor---------#######-------------oooo----------R-----g------------oo--oo-----------------------------------------------------|-----------------------
--------------------------#####-----------------------------####---------------------oo---------------------------R-----oo--------------------##--------|-----------------------
--------------------------------------------------oo------------------------######----------------------------r-------------------------------##--------|-----------------------
--------------------------------------------------------------------------------------------------------########----------------------------####--------|-----------------------
-----------------------------------#####----------------------------------------------------------------------------------------------------####--------|-----------------------
------------------------########--------------------------------------###-------------------------------------------####--####------------######--------|-----------------------
-----------------------------------------------------------M------------------------------------------------------------------------------######--------|-----------------------
---------------------------------o----------------------------------------------------------------####------------------------------------######--------|-----------------------
------------------####----------###------------------------------------------------------------------------------ooo-----------------r----######--------|-----------------------
###############-----------------------------------####-----#####-#####-------------------------------------------###------------################################################
###############-----------------------------------------------------------------------------------------------------------------################################################
