----------------------------------------------------------------------------------------------------------------------------------------------------------------------------------------------------------------
----------------------------------------------------------------------------------------------------------------------------------------------------------------------------------------------------------------
----------------------------------------------------------------------------------------------------------------------------------------------------------------------------------------------------------------
----------------------------------------------------------------------------------------------------------------------------------------------------------------------------------------------------------------
----------------------------------------------------------------------------------------------------------------------------------------------------------------------------------------------------------------
------------------------------------------------------------------------------------------------------------------------------------------------#---------------------------------------------------------------
-------------------------#-#-#-#-#----######---------------------------------------------------###--####-###--###################################---------------------------------------------------------------
###----------------------#-#-#-#-#-----------------------------------------------------------#-#---------#--------------------------------------#---------------------------------------------------------------
####---------------------#-#-#-#-#-------------------------------------------------------##---#----------#--------------------------------------#---------------------------------------------------------------
#####--------------------#-#-#-#-#------------------------------------------------------------#----------#--------------------------------------#---------------------------------------------------------------
------#--##-----------------------------[]--------------------------------------------##--#####-################################################----------------------------------------------------------------
------#--##-----------------------------pP------------------------------------------------#---------------------------------------------------------------------------------------------------------------------
------#--##-----------------------------pP------------------------------------------------#---------------------------------------------------------------------------------------------------------------------
################################################################################################################################################################################################################
