------------------------------------------------------------------------------------------------------------------------------------------------------------------------------------------------------------------------------------------------
------------------------------------------------------------------------------------------------------------------------------------------------------------------------------------------------------------------------------------------------
---------------------------123---------------123---------------------------123---------------123---------------------------123---------------123---------------------------123---------------123-----------------|---------123---------------123
1223--------------123------1231223-----------1231223--------------123------1231223-----------1231223--------------123------1231223-----------1231223--------------123------1231223-----------1231223-------------|123------1231223-----------123
1223--------------123---------1223--------------1223--------------123---------1223--------------1223--------------123---------1223--------------1223--------------123---------1223--------------1223-------------|123---------1223--------------
-----------------------------------------------------------------------------*-------------------------------------------------------------------------------------------------------------------------##--------|------------------------------
------------------------------------------------------------M-----------------------------------------------------------------B-----------------------------------------oooo--------------------------###--------|------------------------------
-----------------------------------------------------------------------------------------------------------------------------------------------------------------------------------------------------####--------|------------------------------
-&&&------------------------------------------------------------------------------------------------------------------------------------------------------------------------------------------------#####--------|----&&&-----------------------
-Q@Q---------------------------------------------------ooo-------------------O---------------------------------------------------------------------------------------------------------------------######--------|----Q@Q-----------------------
&&&&&--------T-------T---------------------T----------------#T-------T---------------------T-----------------T-------T---------------------T-----------------T-------T---[]----------------T------#######----T---|---&&&&&-----------------T----
@@N@@------f-T-------T-ff---------------f--T---------------f#T-------T-ff--#---#--------f--T---------------f-T-------T-ff-----#---------f--T---------------f-T-------T-ffpP-------------f--T----g########--f-T---|---@@N@@--------------f--T----
@@N@@------!-!%%%k---!-!!--gg-g-----kk%k!%-!--kk-#---------!#!%%%%k--!-!!-g#ggk#------%%!%-!J--------------!-!%k%%---!-!!-gg-g#-------k%!%-!---kk-k------kk!-!%%%%---kk!kpP----k------gg!g-!--gg#########--!-!%%%|---@@N@@------------%%!%-!----
################################################################################--#########################################--###--##############################################################################################################
################################################################################--#########################################--###--##############################################################################################################
