--------------------------------
--------------------------------
-----------p--------------------
-----------p--------------------
-----------p--------------------
-----------p--------------------
-----------p--------------------
-----------p--------------------
-----------p--------------------
-----------p--------------------
-----------p--------------------
----------{}--------------------
----------dD--------------------
################################
################################
