--------------------------------------------------------------------------------------------------------------------------------------------------------------------------------
--------------------------------------------------------------------------------------------------------------------------------------------------------------------------------
--------------------------------------------------------------------------------------------------------------------------------------------------------------------------------
--------------------------------------------------------------------------------#-------#---------------------------------------------------------------------------------------
--------------------------------------------------------------------------------#-------#---------------------------------------------------------------------------------------
-----------------------#-----------------------------------------------------------------------------------?--?--?--------------------------------------------------------------
-----------------------#------M------#-----------#----------#------#------------------------------------------------------------------------------------------------------------
###-----------------------------------------------------------------------------------------------------------------------------------------------------------------------------
####----------------------------------------------------------------------------------------------------------------------------------------------------------------------------
#####-----------------------------------------------------------------------#-------#-------#-------------?--?--?---------------------------------------------------------------
------------------------------#-------------------------------------------------------------------------------------------------------------------------------------------------
--------------------------------------------------------------------------------------------------------------------------------------------------------------------------------
--------------------------------------------------------------------------------------------------------------------------------------------------------------------------------
#############--#################################################################################################################################################################
#############--#################################################################################################################################################################
