----------------------------------------------------------------------------------------------------------------------------------------------------------------------------------------------------------------
----------------------------------------------------------------------------------------------------------------------------------------------------------------------------------------------------------------
------------------------------------------------------------------------------------------------------------------------------------------------------------------------------------------|---------------------
--------------------------------l-------------------------------------------------------------------------------l-------------------------------------------------------------------------|---------------------
------------------------------------------------------------------------------------------------------------------------------------------------------------------------------------------|---------------------
------------------------------------mB---------------------------------------------------------------------------i--------------------------------------------------------------##--------|---------------------
-----------------------------------------------------------------------------------------#BBB-----------------------------------------------------------------------------------##--------|---------------------
----------------------------------------------------------------------------oo----------##----------------------------------------------------------#BB-------------------------##--------|---------------------
---------------------------------------------------------------------------------------###I--------------ooo------------------#BB-M?---------------##------------------------#--##--------|---------------------
----------------??-----------------###---BBO------------------ooo-------##-------------###-----------------------i-----------##-------------------###--BO-------------------##--##--------|---------------------
--------------------------------####-----------------------------------###-----------#-###--B---------[]--------------------###------------------####----------------------###--##--------|---------------------
-----------------------------#####------------------------------------####----------##-###------------pP-------------------####-----------------#####---BBB---------------####--##--------|---------------------
--------------------------######-------------------------------------#####-------------###--------------------------------#####---BBBBB--------######--------------------#####--##--------|---------------------
####################--########------###--################--###############---################---###############################-------##-###########------##########---#######--################################
####################--########------###--################--###############---################---###############################-------##-###########------##########---#######--################################
