--------------------------------------------------------------------------------------------------------------------------------------------------------------------------------------------------------------------------------
--------------------------------------------------------------------------------------------------------------------------------------------------------------------------------------------------------------------------------
-------------------------------------------------------------------------------------------------------------------------------------------------------------------------------------------------------|------------------------
-------------------------------------------------------------------------------------------------------------------------------------------------------------------------------------------------------|------------------------
-------------------------------------------------------------------------------------------------------------------------------------------------------------------------------------------------------|------------------------
------------------------------------------------------------------------------------------B*B------------------------------------------------------------------------------------------------##--------|------------------------
---------------------------------------------------------------------------------------------------------------------------------------------------------------------------------------------##--------|------------------------
------------------------------------------------------------------------------------------------------------------------------------------------------------[]-------------------------------##--------|------------------------
------------------------------------------------------------------------------------------------------------------------------------------------------------pP----------------------------#--##--------|------------------------
-----------------------------------------------------------------------------------------#####-----------------------------------------------------#+BB-----##---------------------------##--##--------|------------------------
--------------------------------------------[]-----[]------------------------------------#--------------------------#------------------------------#--------pP--------------------------###--##--------|------------------------
--------------------------------------------pP-----pP------------------------------------#--------------------------#------------------------------#--------pP-----[]------------------####------------|------------------------
#####-----------k-----ggg--------ggg--------kk-----pP---------------ggg--------ggg-------#----------------ggg-------#-------gggk----------ggg------kk-------pP-----pP-----------------#####------------|---#####----------------
#################################################--#########################################----##################--####################################---#####################################################################
