--------------------------------------------------------------------------------------------------------------------------------------------------------------------------------------------------------------------------------
--------------------------------------------------------------------------------------------------------------------------------------------------------------------------------------------------------------------------------
-----####################################################################################+###############################################-----------------------#######p##################---###################################
-----------------------------------------------------##--######--####------####----------------------------------------------------------------------------------------p-#######-------------###################################
-----------------------------------------------------##--g#####--####------####----------------------------------------------------------------------------------------p-#######-------------###################################
-----------------------------------------oooo------##--------##----B----BB----------oooooo-----------------------------------------------------------------------------p-#######-------------###################################
---------------------------------------------------##--------##----B----BB---------------------------------------------------------------------------------------------p-#######-------------###################################
---------------------------------------B-BBBB-*----##--------##----B----BB----------BBBBBB----------------------------------------------------------------------------{}-#######-------------###################################
-----------------------------O---------BoB--BoB----##-----oooo#gg--Bom--BO----------BBBBBB-------------------------------------------------------BBBBBm---gg----------dD-#######-------------###################################
----------M????--------#-#-------------BBB--BBB----##-BB--BBBB#----BBB--BB--BBBB-----------------------------[]-------------------------##-------------------------------#######-------------###################################
---------------------#-#-#-#---#----------------------BB-----------------------------------------------[]----pP-----------BB-----------###----------------------B###############--[]--[]--[]-###################################
-----------------g-#-#-#-#-#---#-#--------------------BB-----------------------------------------------pP----pP----[]-----BB----------####----------------------B###############--pP--pP--pP-###################################
----------------g#-#-#-#-#-#-g-kk#---------k--g-g---------------------------------------------------------------------ggg-BB-----g---#####----------------------B#r#############-------------###################################
################################################################################---#####################################--##--###########-------########-------#################################################################
################################################################################---#####################################--##--###########-------########-------#################################################################
