----------------------------------------------------------------------------------------------------------------------------------------------------------------------------------------------------------------------------------------------------------------
----------------------------------------------------------------------------------------------------------------------------------------------------------------------------------------------------------------------------------------------------------------
----------------------------------------------------------------------------------------------------------------------------------------------------------------------------------------------------------------------------------------------------------------
--------------------B-------------------------------------------------------------------------------------------------------------------------------------------------------------------------------------------------------------------------------------------
--------------------B----------------------O--------------------------------------------------------------------------------------------------------------------------------------------------------------------------------------------------------------------
--------------------B-------------------------------------------BBB----------------------------------------------------BBB--------------------------------------------------------------------------------------------------------------------------------------
------------------------------------------------------------------------------[]--------------------------------------------------------------------------------B-------------------[]--------------------------------------------------------------------------
----------------------------------------------------------------?-------------pP--------------------------------------------------------------------------------B-------------------pP--------------------------------------------------------------------------
----------------------------------------------ggg--------------?-?------------pP-------B--------------------------------------------------------------------------oooooooooo--------pP--------------------------------------------------------------------------
----------------------BBBBBBB-------------------------?M?---------?---------BOpPB*-------------------------[]----------BBBB-------------------[]----------t------BBBBBBBBBBB----#---pP--------------------------------------------------------------------------
----------------------BBBBB---------------------------------------------[]----pP----[]---[]-------------#--pP--##-------------------------[]--pP----------#--------------------##---pP--------------------------------[]----------------------------------------
----------------------BBBBB---------------------------------------------pP----pP----pP---pP------------##--pP--##------------------[]-----pP--pP---------##-------------------###---pP--------------------------------pP----------------------------------------
---------------------------ooo------------------------------------------pP---kpP---tpP--tpP------------kk--pP--##------------------pP----kpP--pP--------###----------------kk####--tpP--------------------------------pP----------------------------------------
###########--##--#---####################################################################################--##--#################################--#####################################--#######################################################################
