--------------------------------------------------------------------------------------------------------------------------------------------------------------------------------------------------------------------------------
--------------------------------------------------------------------------------------------------------------------------------------------------------------------------------------------------------------------------------
---------------------------123---------------123---------------------------123---------------123---------------------------123---------------123---------------------------123---------------123--------|------------------123--
1223--------------123------1231223-----------1231223--------------123------1231223-----------1231223--------------123------1231223-----------1231223--------------123------1231223-----------1231223----|---------123------12312
1223--------------123ooo------1223--------------1223--------------123---------1223----oo--------1223--------------123-------h-1223--------------1223---------r----123-------oo1223--------------1223----|---------123---------12
-----------------------------BBBBBm--------------------------------------------------HBB------------------------------BBBBBBB*---------------------------BBBBB--------------BBBB--------------##--------|-----------------------
---------------------------------------------------------------------------------------------------------------------------------------------------------------------------------------------###--------|-----------------------
-----------------C---------------------------------------------------##----------h-----------------------------------------------------------------------------------------------------------###--------|-----------------------
-&&&-------------c-----------ooo---------------------------------g--###------------------BBB----------------------------h-----------------------------------------------------------------J#-###--------|----&&&----------------
-Q@Q-----------####----------BBBBBB-----------h##----------------#--###-------?????-i---------------------------------BBBBBBBB---------------------BBB------------------m-----------------##-###--------|----Q@Q----------------
&&&&&--------T##-----T---------------------T--###------[]----T-g##--###--------------------T-----------------T-------T-----------#---------T-----------------T-------T--------------------##-###--------|---&&&&&----T----------
@@N@@------f-###-----T-ffY--------------f--T-#####-----pP--f-T-###--###ff---------------f--T---------------C-T-----[]T-ff--------#------f--T-Om------------f-T-------T-ff----[]---------#-##-###--------|--f@@N@@----T-ff-------
@@N@@------!####%%---!-k!y------------%%J%-!######-----pP--!-!####--###!!-------------%%!oo!--------------Jc-!%%%%-pP!-!!--------#----%%ttt!---------------gg!%%%%-J-!J!!----pP-------%##-##-###--------|--!@@N@@%---!-!!-------
##########################---#####################################--########################----###############################--###############-------###################---##--########-##-###################################
##########################---#####################################--########################----###############################--###############-------###################---##--########-##-###################################
