--------------------------------------------------------------------------------------------------------------------------------------------------------------------------------
--------------------------------------------------------------------------------------------------------------------------------------------------------------------------------
--------------------------------------------------------oo---------------------------------------------------------------------------------------------|------------------------
-------------------------------------------------M-----####-------------------o------------------------------------------------------------------------|------------------------
-----------------------------------------------------------------------------###-------------------------oo--------------------------------------------|------------------------
---------------------------------------------------------------------------------o------o-o-------------####-------------------------------------------|------------------------
--------------------------g----------o----ooo-------k-------------o---o---o----------------------------------o-----------------------------------------|------------------------
----------------------######-------------------######------------###-###-###--------------------------------###----------------------------------------|------------------------
-------------------------------------------------------------------------------------------------------------------------------------------------------|------------------------
-------------------------------------------####-----ooo------------------------------------------###------------------------k-k------------------------|------------------------
------------------#####-------------------------------k-----------------------------------------------------o----------############--------------------|------------------------
----------------------------------------------##########----------------------------####-------------------#####---------------------------------------|------------------------
-------------------------------oo---#######------------------------------k-----------------------------------------------------------------------------|------------------------
###############---------------###--------------------------------################-----------------------------------###------------------------#################################
###############--------------------------------------------------------------------------------------------------------------------------------#################################
