--------------------------------------------------------------------------------------------------------------------------------------------------------------------------------------------------------------------------------
--------------------------------------------------------------------------------------------------------------------------------------------------------------------------------------------------------------------------------
------------------------------------------------------------------------------------------------------------------------------------------------------------------------------------------------------|-------------------------
------------------------------------------------------------------------------------------------------------------------------------------------------------------------------------------------------|-------------------------
--------------------------------------------------------------------------------g-g----------------------------------------------------------------------------------------------------------#--------|-------------------------
----------------------?---------------------------------------------------------BBBBBBBB---BBB?--------------M-----------BBB----BBBB--------------------------------------------------------##--------|-------------------------
-------------------------------------------------------------------------------------------------------------------------------------------------------------------------------------------###--------|-------------------------
------------------------------------------------------------------------------------------------------------------------------------------------------------------------------------------####--------|-------------------------
----------------------------------------------------------------+------------------------------------------------------------------------------------------------------------------------#####--------|-------------------------
----------------?---BMB?B---------------------[]---------[]------------------BMB--------------O-----B*----?--?--?-----B----------BB------#--#----------##--#------------BB?B------------######--------|-------------------------
--------------------------------------[]------pP---------pP-----------------------------------------------------------------------------##--##--------###--##--------------------------#######--------|-------------------------
----------------------------[]--------pP------pP---------pP----------------------------------------------------------------------------###--###------####--###-----[]--------------[]-########--------|-------------------------
------------------------g---pP--------gg------pP---------pP-----------------------------------------gg-----k---------gg--------gg--gg-####--####----#####--####----pP------------ggpP#########--------|---#####-----------------
#####################################################################--###############---################################################################--#####################################################################
