--------------------------------------------------------------------------------------------------------------------------------------------------------------------------------
--------------------------------------------------------------------------------------------------------------------------------------------------------------------------------
------------------1223----------------------------------oo--------1223------------""""""""------------------------1223-------------------"""""---------|-----&&&--1223----------
---1223-----------1223---------------------------M-1223####-------1223--------o--------------------1223-----------1223-----------------------------1223|-----Q@Q--1223----------
---1223--------------------------------------------1223-!!-------------------###-------------------1223--oo----------------------------------------1223|----&&&&&---------------
--------------------------------------------------------!!--------------------!--o------o-o-------------####------R------------------------------------|----@@N@@---------------
--------------------------g----------o123-ooo-------r---!!--------o---o---o---!-------123----------------!!--o------------------------123--------------|----@@N@@---------------
---------123----------######-------123123------######---!123-----###-###-###--!----123123----------------123###--------------------123123--------------|-123&&&&&---------------
-&&&-----123-----------!!!!--------123----------!!!!----!123------!---!---!---!----123-------------------123-!---------------------123-----------------|-123@N@N@---------------
-Q@Q-------------------!!!!----------------####-!!!!ooo-!!--------!---!---!---!------------------###-----!!--!--------------r-r------------------------|----@N@N@---------------
&&&&&-------------#####!!!!-----------------!!--!!!!--r-!!--------!---!---!---!-------------------!------!!-o!---------############--------------------|----@@@@@---------------
@@N@@--------------!!!-!!!!-123-------------!!##########!!--------!---!---!-123-----####------123-!------!!#####--------!!!!123!!!------------123------|----N@N@N-----------123-
@@N@@--------------!!!-!!!!-123oo---#######-!!123!!!!!!-!!--------!---!--r!-123------!!-------123-!------!!-!!!---------!!!!123!!!------------123------|----N@N@N-----------123-
################---!!!-!!!!---###----!!!!!--!!-!!!!!!!!-!!-------################----!!-----------!------!!-!!!-----###-!!!!!!!!!!--------------################################
################---!!!-!!!!----!-----!!!!!--!!-!!!!!!!!-!!--------!!!!!!!!!!!!!!-----!!-----------!------!!-!!!------!--!!!!!!!!!!--------------################################
