------------------------------------------------------------------------------------------------------------------------------------------------------------------------------------------------------------------------------------------------
------------------------------------------------------------------------------------------------------------------------------------------------------------------------------------------------------------------------------------------------
################################################################################################################################################################################################################################################
###############------------####------------------------------------------------------------------------------------------------------------------------------------------------------------------------------##---------------------------------
###############------------####------------------------------------------------------------------------------------------------------------------------------------------------------------------------------##---------------------------------
-------------------------------------------------------------------------------------------------------------------------------------------------------------------------------------------------------------##---------------------------------
-------------------------------------############------###########---##################-####-------##-###-#########---###--#######--###--################---------------------------------------------------------------------------------------
###----------------------------------############--------------------##################-##-------------#-----######----------------------#------------------------------------------------------------------------------------------------------
####--------------------------------#############--------------------##################-#--------------------######----------------------#------------------------------------------------------------------------------------------------------
#####-----------------------------###############--------------------##################----------------------######----------------------#-------------------------------------------------------------W----###---------------------------------
###############-----------#####-----------------------#############-------------------------###------------------------###--#######--###----###################---###--########--##--##--######-=============##---------------------------------
###############-----------#####-------------------------------------------------------------###---------------------------------------------###################---###--########--##--##--######-------------###---------------------------------
###############-----------#####-------------------------------------------------------------###--------------------------------------------####################---###--########--##--##--######-------------###---------------------------------
###############-----------#########################################################################----#--#####################################################################################-------------####################################
###############-----------#########################################################################----#--#####################################################################################-------------####################################
