--------------------------------------------------------------------------------------------------------------------------------------------------------------------------------------------------------------------------------
--------------------------------------------------------------------------------------------------------------------------------------------------------------------------------------------------------------------------------
-----------------------------------------------------------------------------~~----------------------------------------------------~-------------------------------------------------------~~~~~~~~~~~~~~~~~~~~~~~~~~~~~~~~~~~~~
-----------------------------------------------------------------------------~~----B-----------------------------------------------~-----------------------------------------B-------------~~~~~~~~~~~~~~~~~~~~~~~~~~~~~~~~~~~~~
-----------------------------------------------------------------------------~~----B----------q------------------------------------~~~~~~~~~---------------------------------B-------------~~~~~~~~~~~~~~~~~~~~~~~~~~~~~~~~~~~~~
---------------------------ooo----------------------------------------------------~~~-----------------B-----------------------------------------------------~~~---~~~-------~~~~~---~~~~---~~~~~~~~~~~~~~~~~~~~~~~~~~~~~~~~~~~~~
------------------------------------------------------------------------------------------------------B----------ooo----------------------------------------~-------~-----------------------~~~~~~~~~~~~~~~~~~~~~~~~~~~~~~~~~~~~
------------------------------------------B----------------------------------q------------------------B-----------------------------------------------------~-------~-----------------------~d~~~~~~~~~~~~~~~~~~~~~~~~~~~~~~~~~~
-------------------------q-------B--------B---------q------------~-----~------------------------------B------------~~---------------------------------------~-------~-----------------------~D~~~~~~~~~~~~~~~~~~~~~~~~~~~~~~~~~~
------------------~~~------------B--------~~------B--------------~-----q-----------q------------------~~----------------B--------~-----------~--------q-----~--ooo--~-------~~~~~---~~~~---~~~~~~~~~~~~~~~~~~~~~~~~~~~~~~~~~~~~~
-----------B---------------------B------------q---B-------------~~-ooo-~~----##----------B------------------------------B--------~-----------~-------B------~-------~----------------------~####################################
-----------B---------------------B----------------B----q--------~~-----~~----##----------B-----------ooo----------------B--------~~--o---o--~~-----B-B------~-------~---------------------~~####################################
-----------B--oo------q----------B--ooo-----------B-------------~~-----~~----##----------Bq--------------q--------------B--------~~---ooo---~~-----B-B------~--ooo--~--------q-----q-----~~~####################################
##################################################################-----############################################################---------#################-------############################################################
##################################################################-----############################################################---------#################-------############################################################
