--------------------------------------------------------------------------------------------------------------------------------------------------------------------------------
--------------------------------------------------------------------------------------------------------------------------------------------------------------------------------
################------------------#################################################----------######----------------#############################################################
################-------M----------#################################################----------######----------------#############--------------##--------------------------------
################------------------#################################################----------######----------------#############--------------##--------------------------------
----------------------------------#################################################---------------------------------------------BBBBBB--------##--------------------------------
----------------------------------------------------------------------------------#---------------------------------------------------------------------------------------------
###-------------------###-------------------------------------------------------------------------------------------------------------------------------------------------------
####--------------------------------------------------------------------------------------------------ooo-----------------------------------------------------------------------
#####-------------##-------##--------#####################################-------------------------------------------------------------w-----###--------------------------------
################----------------##----------------------------------------------####--------#######---------#--##--#####--##--##=============###--------------------------------
################----------------##----------------------------------------------####--------#######----#----#--##--#####--##--##-------------###--------------------------------
################----------------##----------------------------------------------####--------#######---ooo---#--##--#####--##--##-------------###--------------------------------
################^^^^^^^^^^^^^^^^####################################################^^^^^^^^#################^^##^^#############^^^^^^^^^^^^^###################################
################::::::::::::::::####################################################::::::::#################::##::#############:::::::::::::###################################
