------------------------------------------------------------------------------------------------
------------------------------------------------------------------------------------------------
-------------------------~~----~~---------------------------~~~~~~~~~~~~~~~~~~~~~~~~~~~~~~~~~~~~
-------------------------~~----~~---------------------------~~~~~~~~~~~~~~~~~~~~~~~~~~~~~~~~~~~~
---------------B---------~~----~~-----~~~~~~----------------~~~~~~~~~~~~~~~~~~~~~~~~~~~~~~~~~~~~
---------------B----------------------B----B----------oooo--~~~~~~~~~~~~~~~~~~~~~~~~~~~~~~~~~~~~
-----------~~~~~----------------------B----B----------~~~~---~~~~~~~~~~~~~~~~~~~~~~~~~~~~~~~~~~~
----------------------oooooooooo------B----B-----------------~d~~~~~~~~~~~~~~~~~~~~~~~~~~~~~~~~~
--------------------------------------B----B------oooo-------~D~~~~~~~~~~~~~~~~~~~~~~~~~~~~~~~~~
--------------------B-----------------------------~~~~------~~~~~~~~~~~~~~~~~~~~~~~~~~~~~~~~~~~~
------------B-------B-----#-----#---------------------------####################################
------------B-------B-----#-----#-------------B-------------~###################################
------------B------qB-----#-----#--q----oo---qB------------~~###################################
######################----##----######--##--####################################################
######################----##----######--##--####################################################
