--------------------------------
--------------------------------
------------------1223----------
---1223-----------1223----------
---1223-------------------------
--------------------------------
--------------------------------
---------123--------------------
-&&&-----123--------------------
-Q@Q--------[]------------------
&&&&&-------pP------------------
@@N@@-----{}(P--------------123-
@@N@@-----dD)P--------------123-
################################
################################
