----------------------------------------------------------------------------------------------------------------------------------------------------------------------------------------------------------------
----------------------------------------------------------------------------------------------------------------------------------------------------------------------------------------------------------------
-&&&---------------123--------------1223---------------------------123--------------1223---------------------------123--------------1223---------------------------123--------------1223--|---------------------
-Q@Q----123--------123-----12223l---1223----------------123--------123-----12223----1223----------------123-----l--123-----12223----1223----------------123--------123-----12223----1223--|-------------123-----
&&&&&---123----------------12223------------------------123----------------12223------------------------123----------------12223------------------------123----------------12223----------|-------------123-----
@@N@@-------------------------------mB---------------------------------------------------------------------------i--------------------------------------------------------------##--------|---------------------
@@N@@------------------------------------------------------------------------------------#BBB-----------------------------------------------------------------------------------##--------|---------------------
&&&&&&&&&&&&&&&&&&&&&&&&&&&&&&&&&&&&&&&&&&&&&&&&&&&&&&&&&&&&&&&&&&&&&&&&&&&&oo&&&&&&&&&&##&&&&&&&&&&&&&&&&&&&&&&&&&&&&&&&&&&&&&&&&&&&&&&&&&&&&&&&&&&#BB&&&&&&&&&&&&&&&&&&&&&&&&&##&&&&&&&&|&&&&&&&&&&&&&&&&&&&&&
@N@N@@@@@@@@@@@@@@@@@@@@@@@@@@@@@@@@@@@@@@@@@@@@@@@@@@@@@@@@@@@@@@@@@@@@@@@@@@@@@@@@@@@###I@@@@@@@@@@@@@@ooo@@@@@@@@@@@@@@@@@@#BB@M?@@@@@@@@@@@@@@@##@@@@@@@@@@@@@@@@@@@@@@@@#@@##@@@@@@@@|@@@@@@&&&@@@@@@@@@@@@
@N@N@@@@@@@@@@@@??@@@@@@@@@@@@@@@@@###@@@BBO@@@@@@@@@@@@@@@@@@ooo@@@@@@@##@@@@@@@@@@@@@###@@@@@@@@@@@@@@@@@@@@@@@i@@@@@@@@@@@##@@@@@@@@@@@@@@@@@@@###@@BO@@@@@@@@@@@@@@@@@@@##@@##@@@@@@@@|@@@@@@Q@Q@@@@@@@@@@@@
@@@@@@@@@@@@@@@@@@@@--@@@@@@@@@@####@@@--@@@@@@@@@@@@@@@@--@@@@@@@@@@@@###---@@@@@@@@#@###@@B---@@@@@@[]@@@@@@@@@@@@@@@@@@@@###-------@@-@@@@@@@@####@@@@@@@@@@@@@@@---@@@@###--##@@@@@@@@|@@@@@&&&&&@@@@@@@@@@@
N@N@N@@@@@@@@@@@@@@@--@@@@@@@#####@@@@@--@@@@@@@@@@@@@@@@--@@@@@@@@@@@####---@@@@@@@##@###@@@---@@@@@@pP@@@@@@@@@@@@@@@@@@@####-------@@-@@@@@@@#####@@@BBB@@@@@@@@@---@@@####--##@@@@@@@@|@@@@@@@N@@@@@@@@@@@@@
N@N@N@@@@@@@@@@@@@@@--@@@@######@@@@@@@--@@@@@@@@@@@@@@@@--@@@@@@@@@@#####---@@@@@@@@@@###@@@---@@@@@@pP@@@@@@@@@@@@@@@@@@#####---BBBBB@-@@@@@@######@@@@@@@@@@@@@@@---@@#####--##@@@@@@@@|@@@@@@@N@@@@@@@@@@@@@
####################--#########------##--################--###############---################---###############################-------##-############------#########---#######--################################
####################--#########------##--################--###############---################---###############################-------##-############------#########---#######--################################
