------------------------------------------------------------------------------------------------
------------------------------------------------------------------------------------------------
------------------------------------------------------------------------------------------------
------------------------------------------------------------------------------------------------
--------------------------------ooo------------------ooo----------------------------------------
------------------------------------oooooooooooooooo--------------------------------------------
---------------oooooooooooooooo-----------------------------------------------------------------
------------------------------------------------------------------------------------------------
------------------------------------------------------------------------------------------------
------------------------------------------------------------------------------------------------
------------------------------------------------------------------------------------------------
------------------------------------------------------------------------------------------------
---------------------------------------------------------------------ooo------------------------
####-#########################################################----------------------------------
------------------------------------------------------------------------------------------------
