------------------------------------------------------------------------------------------------------------------------------------------------------------------------------------------------------------------------------------------------
------------------------------------------------------------------------------------------------------------------------------------------------------------------------------------------------------------------------------------------------
---------------------------123---------------123---------------------------123---------------123---------------------------123---------------123---------------------------123---------------123------------------------|--123---------------123
1223--------------123l-----1231223-----------1231223--------------123------1231223-----------1231223--------------123------1231223-----------1231223--------------123------1231223-----------1231223--------------123---|--1231223-----------123
1223--------------123----J----1223--------------1223--------------123---------1223--------------1223--------------123---------1223--------------1223--------------123---------1223--------------1223--------------123---|-----1223--------------
------------------------##-----------------B+BBBBBBBBBBBBBBBBBBBBBBBBBBBBBBB----------------------------------------------------------------------------------------------------------------------------------##--------|-----------------------
-----------------------###------------------------------------------------------------------------------------------------------------------------------------------------------------------------------------##--------|-----------------------
----------------------####----------------------------------------------------------------------------------------------------------------------------------------------------------------g----------------J--##--------|-----------------------
-&&&------------------####---------------------------------------------------------------------------------------------C------------------------------------------------------------------#----------------#--##--------|----&&&----------------
-Q@Q----------------#-####---????--------------------------------------------BB--------------------Bm---------BB------B#O-----------------------------------[]--------------------------g##----------------#--##--------|----Q@Q----------------
&&&&&--------T---J-##-####-----------------T-----------------T-------T---------------------T-C---------------T-------T-------C-------------T----------------pP-------T---------J--------###T---C---------#-#--##-----T--|---&&&&&----------T----
@@N@@------f-T----###-####--------------f--TY--------------f-T-------T-ff------------C--f--T-c-----------C-f-T-------T-ff----c-----[]---f--T--[]-----------fpP-----[]T-ff------C-------####T---c--------##-#--##-----T-f|---@@N@@-------f--T----
@@N@@------!-!%-%####-####------------%%!%-!y------------J-!-!%-%%J--J-!!------------c%%!%-!JC-J---------c-!-!%t%%-C-!-!!t-t-c--------%%!%-J---------------!-!%%%%---!-!!-J-J--c------#####!-t-C-------###-#--##%%---!-!|---@@N@@-----%%!%-!----
###############-#####-##############-########-####-#-###-######-##############--####-#####################################################-#####-#-#------####################-#---#######################-#--##################################
###############-#####-##############-########-####-#-###-######-##############--####-#####################################################-#####-#-#------####################-#---#######################-#--##################################
