------------------------------------------------------------------------------------------------------------------------------------------------------------------------------------------------------------------------------------------------
------------------------------------------------------------------------------------------------------------------------------------------------------------------------------------------------------------------------------------------------
################################################################################################################################################################################################################################################
################------------####------------------------------------------------------------------------------------------------------------------------------------------------------------------------------##--------------------------------
################------------####------------------------------------------------------------------------------------------------------------------------------------------------------------------------------##--------------------------------
--------------------------------------------------------------------------------------------------------------------------------------------------------------------------------------------------------------##--------------------------------
--------------------------------------############-----###########----######################-------##-###-##########--###--#######--###--################---------------------------------------------------------------------------------------
###----------------------------------#############--------------------####################-------------#------######---------------------#------------------------------------------------------------------------------------------------------
####--------------------------------##############--------------------###################---------------------######---------------------#------------------------------------------------------------------------------------------------------
#####-----------------------------################--------------------##################----------------------######---------------------#-------------------------------------------------------------W-----###--------------------------------
################-----------#####----------------------#############--------------------------###-----------------------###--#######--###-----###################---###--########--##--##--######=============###--------------------------------
################-----------#####-------------------------------------------------------------###--------------------------------------------####################---###--########--##--##--######-------------###--------------------------------
################-----------#####-------------------------------------------------------------###-------------------------------------------#####################---###--########--##--##--######-------------###--------------------------------
################^^^^^^^^^^^#########################################################################^^^#^^^#####################################################################################^^^^^^^^^^^^^###################################
################:::::::::::#########################################################################:::#:::#####################################################################################:::::::::::::###################################
